AAACCCAAGGTGCCAA	ExciteL4
AAACCCACAATGGCCC	OPCs
AAACCCATCCAGTACA	ExciteL4
AAACGAAAGGTTGAGC	MOLs
AAACGAAAGTTCAACC	Pericytes
AAACGAAAGTTCCTGA	ExciteL4
AAACGAACAGCGAGTA	OPCs
AAACGAACAGTGCGCT	ExciteL6
AAACGAAGTCATCCGG	ExciteL6
AAACGAATCCTCGATC	Microglia
AAACGCTAGCATAGGC	ExciteL6
AAACGCTAGCGCATCC	Microglia
AAACGCTCAACGCATT	MOLs
AAACGCTCAACTGTGT	MOLs
AAACGCTGTAGTAAGT	MOLs
AAACGCTGTCGCGGTT	ExciteL6
AAACGCTTCGGACAAG	Astrocytes
AAAGAACCATCCGGCA	ExciteL6
AAAGAACCATCCGGTG	ExciteL6
AAAGGATAGACCAACG	ExciteL6
AAAGGATAGCGGACAT	MOLs
AAAGGATCATGAGATA	MOLs
AAAGGATGTCGAAGCA	ExciteL5
AAAGGATGTCTCGGGT	COPs
AAAGGATTCAAAGACA	ExciteL4
AAAGGATTCATTGGTG	MOLs
AAAGGGCCAGACCATT	Astrocytes
AAAGGGCTCCACAAGT	COPs
AAAGGGCTCGCTGATA	ExciteL4
AAAGGTAAGTGGACTG	InhibNeuron
AAAGGTACACACCTTC	ExciteL6
AAAGGTAGTATGGGAC	MOLs
AAAGTCCAGAGTACCG	ExciteL6
AAAGTCCCACCCATAA	InhibNeuron
AAAGTCCTCCTAGCGG	ExciteL4
AAAGTGACACATAACC	Endo
AAATGGAAGAGTCCGA	InhibNeuron
AAATGGAAGCGCCCAT	MOLs
AAATGGACAATCGCAT	MFOLs
AAATGGACACCTGATA	ExciteL6
AAATGGACACTGTGTA	ExciteL4
AAATGGAGTAGCGCTC	MOLs
AAATGGAGTCGCATCG	ExciteL6
AAATGGATCTGCGGGT	Astrocytes
AACAAAGAGCAGATAT	ExciteL23
AACAAAGCAACACGAG	ExciteL4
AACAAAGGTAGGTACG	ExciteL5
AACAAAGGTCACAATC	MOLs
AACAAAGGTCTGTTAG	Endo
AACAACCAGCACCAGA	Microglia
AACAACCAGGAGCAAA	ExciteL6
AACAACCAGGGAGATA	NIPCs
AACAACCAGGGTGGGA	ExciteL4
AACAACCCAAACCACT	ExciteNP
AACAACCCAGATACCT	ExciteL23
AACAACCGTCATCCCT	ExciteL6
AACAAGAAGCTGACCC	Microglia
AACAAGAGTCTGTGGC	MFOLs
AACACACAGCCAAGCA	ExciteL6
AACACACAGGGACAGG	ExciteL6
AACACACAGGTAGACC	ExciteL4
AACACACAGTTTCAGC	ExciteL4
AACACACTCCGCTTAC	ExciteL4
AACAGGGCAACTCGAT	MOLs
AACAGGGCACGCTTAA	MOLs
AACAGGGGTCTCTCCA	ExciteL6
AACAGGGTCTCGTCAC	ExciteL4
AACCAACAGAGGATCC	ExciteL6
AACCAACAGGGTAATT	ExciteL4
AACCAACCAATTCTTC	MOLs
AACCAACCATCGATAC	ExciteL4
AACCAACTCAACTTTC	ExciteL23
AACCAACTCAGATGCT	MOLs
AACCAACTCGAACGGA	Microglia
AACCACAAGGTGCCTC	ExciteL6
AACCACACAACTCGTA	ExciteL6
AACCACACACTGTGTA	OPCs
AACCACATCAGATGCT	MOLs
AACCACATCAGGGATG	Macrophages
AACCATGCAGGCTATT	ExciteL4
AACCATGTCCAAGCCG	ExciteL4
AACCCAAAGACGGATC	ExciteL5
AACCCAAAGCGTGCTC	ExciteL4
AACCCAAGTTGTTTGG	ExciteL4
AACCCAATCAGAGTGG	ExciteL4
AACCTGAAGGACGGAG	ExciteL4
AACCTGACAACGTTAC	ExciteL4
AACCTGACATTCACAG	ExciteL6
AACCTGAGTAACAAGT	OPCs
AACCTGAGTCTAGATC	ExciteL6
AACCTGATCGAATGCT	OPCs
AACCTTTCAGCGACCT	ExciteL4
AACCTTTGTGGGTATG	ExciteL4
AACCTTTGTGTCCACG	MOLs
AACGAAAAGTACAGCG	ExciteL4
AACGAAAGTAATGATG	MOLs
AACGAAAGTATCGCTA	MOLs
AACGAAAGTCGCTCGA	ExciteL6
AACGAAAGTCTACGTA	ExciteL4
AACGGGAAGCCACTCG	MOLs
AACGGGAAGGAACGAA	ExciteL4
AACGGGAAGTTTGGCT	Astrocytes
AACGGGACAAGCTGTT	ExciteL4
AACGGGATCATCGCCT	ExciteL6
AACGTCAAGCGATGAC	ExciteL4
AACGTCATCATTGTGG	ExciteL6
AACGTCATCCTTCAGC	ExciteL4
AACTTCTGTTTGCCGG	MOLs
AACTTCTTCCCATTCG	OPCs
AACTTCTTCTGAGAGG	ExciteL4
AACTTCTTCTGCGGGT	ExciteL6
AAGAACAGTCTAGATC	Astrocytes
AAGAACAGTGCTAGCC	ExciteL5
AAGAACATCAACGAGG	Microglia
AAGAACATCGTCTAAG	ExciteL6
AAGACAAGTAACACCT	MOLs
AAGACTCAGCACACCC	ExciteL6
AAGACTCAGGTTGGAC	ExciteL6
AAGACTCAGTGGTGAC	ExciteL4
AAGACTCCATTAAGCC	ExciteL4
AAGACTCGTTTAGACC	ExciteL4
AAGATAGCAACTCGTA	ExciteL4
AAGATAGCATTGCAAC	ExciteL6
AAGATAGGTCCGTTTC	ExciteL23
AAGATAGGTGATATAG	InhibNeuron
AAGCATCAGGAAGTCC	ExciteL5
AAGCATCCAAGCCCAC	COPs
AAGCATCGTATGACAA	ExciteL4
AAGCATCGTGTGCTTA	ExciteL6
AAGCATCTCCGCCTAT	ExciteL4
AAGCCATAGATTTGCC	ExciteL4
AAGCCATCACCTTCCA	Pericytes
AAGCCATCAGGTCTCG	ExciteL4
AAGCCATCAGTCTCTC	ExciteL4
AAGCCATGTGCATACT	ExciteL4
AAGCCATTCAGGTAAA	ExciteL23
AAGCCATTCGCCTTTG	ExciteL6
AAGCGAGCAAGCTACT	ExciteL6
AAGCGAGCAGCTTTCC	ExciteL4
AAGCGAGTCTATGTGG	ExciteL6
AAGCGTTGTCTTTCTA	OPCs
AAGGAATAGAGCTGAC	Microglia
AAGGAATCAAGCGCAA	Endo
AAGGAATCAGGCTATT	InhibNeuron
AAGGAATGTAACAGGC	ExciteL6
AAGGAATGTGGTCCCA	ExciteL6
AAGGAATTCATTCACT	InhibNeuron
AAGGAATTCCACTTTA	ExciteL4
AAGGAATTCTGATGGT	Pericytes
AAGGTAACACAAGCTT	InhibNeuron
AAGGTAACAGGATCTT	Microglia
AAGGTAAGTAGCTGTT	COPs
AAGGTAAGTATGGTTC	ExciteL4
AAGGTAAGTGAATGAT	ExciteL4
AAGGTAAGTTCTGACA	ExciteL6
AAGGTAAGTTGTCATG	ExciteNP
AAGGTAATCAGTCAGT	MOLs
AAGGTAATCCTGTACC	InhibNeuron
AAGTACCAGCAGCACA	ExciteL4
AAGTACCAGTGGAAAG	MOLs
AAGTACCTCATTACGG	ExciteL6
AAGTACCTCCCACAGG	MOLs
AAGTACCTCTCGACCT	ExciteL5
AAGTCGTAGCCATTCA	Astrocytes
AAGTCGTCACACGGAA	ExciteL4
AAGTCGTGTCCAGGTC	ExciteL6
AAGTGAAGTCGTACAT	ExciteNP
AAGTGAATCTCTGACC	Microglia
AAGTTCGGTCTGTCAA	Astrocytes
AAGTTCGTCAGACTGT	ExciteL23
AAGTTCGTCGACGACC	InhibNeuron
AATAGAGAGAAGTCCG	Pericytes
AATAGAGCACCTGTCT	Microglia
AATAGAGCAGACTGCC	ExciteL6
AATAGAGGTCCTTAAG	ExciteL5
AATCACGCAATAAGGT	Microglia
AATCACGTCCCTAGGG	InhibNeuron
AATCGACCATGGAATA	ExciteL4
AATCGACTCGATTGGT	ExciteL6
AATCGACTCGCGGTAC	ExciteL6
AATCGACTCGTGCTCT	OPCs
AATCGACTCTGTAAGC	InhibNeuron
AATCGTGGTAGTCTTG	MOLs
AATCGTGTCTCCAAGA	MOLs
AATCGTGTCTCTCTAA	Microglia
AATCGTGTCTTCGACC	ExciteL4
AATGAAGAGATAGTGT	ExciteL6
AATGAAGCATCGTGCG	InhibNeuron
AATGAAGGTACGTACT	OPCs
AATGAAGGTATACCCA	ExciteL5
AATGAAGGTTCCGCGA	ExciteL6
AATGAAGGTTCTCGCT	ExciteL5
AATGAAGTCAAGTGGG	ExciteL4
AATGAAGTCCTCGATC	MOLs
AATGACCAGACCATTC	Astrocytes
AATGACCAGCACGTCC	Astrocytes
AATGACCCAGACAATA	ExciteL6
AATGACCGTCTGCATA	Pericytes
AATGACCGTTCCGTTC	MOLs
AATGACCTCCATCTGC	ExciteL6
AATGACCTCTAGGCAT	InhibNeuron
AATGCCAAGATCGGTG	Astrocytes
AATGCCACAAGCCATT	Pericytes
AATGCCAGTGTCACAT	ExciteL6
AATGCCATCTTTCGAT	Pericytes
AATGGAAAGTATGAGT	ExciteL6
AATGGAACAAGTGACG	ExciteL4
AATGGAACATTGCCTC	ExciteL6
AATGGAAGTTCTATCT	ExciteL4
AATGGAATCAAGCGTT	Microglia
AATGGAATCCCAAGTA	ExciteL23
AATGGCTAGCCTCTGG	MOLs
AATGGCTGTAAGATTG	ExciteL4
AATGGCTGTCAAAGAT	ExciteL6
AATGGCTTCCTCTAGC	ExciteL4
AATGGCTTCGGAGCAA	Astrocytes
AATTCCTAGGTAAACT	ExciteL6
AATTCCTCAGAAGTTA	ExciteL6
AATTTCCCAACACGAG	MOLs
AATTTCCGTACTCCCT	MOLs
AATTTCCGTCTACGAT	ExciteL4
AATTTCCTCGGTGTAT	ExciteL6
AATTTCCTCTGAGTCA	ExciteL6
ACAAAGACAGCGGTTC	MOLs
ACAAAGACATGTACGT	OPCs
ACAAAGACATTGGATC	InhibNeuron
ACAAAGAGTTGCATGT	MOLs
ACAAAGATCTGGCTGG	Pericytes
ACAACCAAGCCGATTT	MOLs
ACAACCACATCATTGG	ExciteNP
ACAACCACATTGAAAG	MOLs
ACAACCAGTCTACACA	ExciteL6
ACAACCATCAACTTTC	ExciteL23
ACAACCATCGTTCATT	COPs
ACAACCATCTCATTGT	ExciteL4
ACAAGCTAGCGTTAGG	OPCs
ACAAGCTGTAGACTGG	Microglia
ACAAGCTTCTGTGTGA	ExciteL6
ACACAGTAGCACTCAT	ExciteL6
ACACAGTAGGGTGAGG	ExciteL4
ACACAGTCACTTGAGT	ExciteL6
ACACAGTGTCGAGTTT	ExciteL4
ACACCAAAGATCGCTT	ExciteNP
ACACCAAAGCGTTCAT	ExciteL5
ACACCAACACGAAAGC	ExciteL6
ACACCAACATGACAGG	ExciteL6
ACACCAAGTTAAAGTG	MOLs
ACACCAATCATCGTAG	InhibNeuron
ACACCAATCCACGAAT	ExciteL5
ACACGCGAGCCAGTAG	Microglia
ACACGCGAGCCTGTGC	ExciteL23
ACACGCGAGTTGCGCC	MOLs
ACACGCGGTTACGTAC	Astrocytes
ACACGCGTCCGACGGT	OPCs
ACACTGAAGAATTCAG	ExciteL6
ACACTGAAGGGTGGGA	Astrocytes
ACACTGAGTTACGATC	ExciteL4
ACACTGATCTGGTGCG	Microglia
ACAGAAAAGTCTAGCT	Pericytes
ACAGAAACAAGTGCAG	OPCs
ACAGAAACATATGGCT	Microglia
ACAGAAAGTGGAAGTC	Microglia
ACAGAAATCGAGCTGC	ExciteL4
ACAGCCGCATCTGTTT	MOLs
ACAGCCGGTAGTGTGG	ExciteL5
ACAGCCGGTCTGTGTA	ExciteL4
ACAGCCGGTTTACGAC	Pericytes
ACAGCCGTCCGTGGTG	MOLs
ACAGCCGTCGCGGTAC	ExciteL6
ACAGGGAAGCATCCCG	ExciteL4
ACAGGGACAAGGATGC	MOLs
ACAGGGACACCGTGCA	ExciteL6
ACAGGGAGTTCTCTCG	MOLs
ACATCCCAGTAAACGT	MOLs
ACATCCCTCCCGATCT	ExciteL4
ACATCCCTCGAAGGAC	ExciteL6
ACATCCCTCGTCGACG	MOLs
ACATCGAAGACTTGTC	MOLs
ACATCGAAGGGAACAA	MOLs
ACATCGAAGTAGACCG	ExciteL6
ACATCGACATAATGCC	ExciteL4
ACATCGACATTCATCT	ExciteNP
ACATCGATCGGTGTAT	ExciteL6
ACATGCAAGCTTGTTG	MOLs
ACATGCACAACGGCTC	ExciteL6
ACATGCACACCAGTTA	Ependymal
ACATGCACATTCTGTT	Astrocytes
ACATGCATCCGTATAG	ExciteL6
ACATGCATCGGTCTAA	ExciteL4
ACATGCATCTCTATAC	ExciteL6
ACATTTCCATCTCATT	Astrocytes
ACATTTCGTACTTCCC	MOLs
ACATTTCGTTGTCTAG	ExciteL6
ACATTTCTCGTCCTCA	Astrocytes
ACCAACAAGCTAAGTA	MOLs
ACCAACACACGTGAGA	OPCs
ACCAACACAGCATTGT	ExciteL4
ACCAACAGTGGAAATT	MOLs
ACCACAAAGTGCACTT	InhibNeuron
ACCACAACAGTTGCGC	ExciteL4
ACCATTTTCACCTCGT	ExciteL5
ACCATTTTCCACACCT	ExciteL4
ACCCAAAAGCCAACCC	ExciteL6
ACCCAAAAGTAGGCCA	MOLs
ACCCAAAAGTTCTACG	ExciteL4
ACCCAAAGTCAACCAT	ExciteL6
ACCCAAAGTGAATAAC	Microglia
ACCCAAAGTGCCTGAC	ExciteL4
ACCCAAATCGAACACT	ExciteL4
ACCCAAATCTCTATAC	ExciteNP
ACCCTCATCATCAGTG	ExciteL4
ACCCTTGAGATTCGAA	MOLs
ACCCTTGAGCACCCAC	MOLs
ACCCTTGTCCTATTGT	Astrocytes
ACCCTTGTCTGTGCAA	Pericytes
ACCGTTCAGGATATAC	ExciteL6
ACCGTTCAGGCTCTAT	InhibNeuron
ACCGTTCCAAGATGGC	ExciteNP
ACCGTTCCACACGGAA	ExciteL4
ACCGTTCGTCATAGTC	ExciteL6
ACCGTTCTCTCATTAC	OPCs
ACCTGAATCTTCGCTG	InhibNeuron
ACCTGTCCAGACCGCT	ExciteL23
ACCTGTCTCGATTGAC	MOLs
ACGATCACAGCTAACT	InhibNeuron
ACGATCATCCGCTTAC	ExciteL4
ACGATCATCGTTCTAT	ExciteL6
ACGATCATCTCATTTG	ExciteL4
ACGATGTCAGAAACCG	ExciteL4
ACGATGTCAGCCGTTG	ExciteL4
ACGATGTTCAACTCTT	ExciteL6
ACGATGTTCTCATTGT	Macrophages
ACGCACGTCCAGTGCG	MOLs
ACGCACGTCCATATGG	InhibNeuron
ACGGAAGAGATGGCGT	ExciteL5
ACGGAAGAGGTTAGTA	ExciteL4
ACGGAAGCACTAAACC	COPs
ACGGAAGCACTCCTGT	MOLs
ACGGAAGGTTGGGATG	ExciteNP
ACGGAAGTCATTCGTT	ExciteL4
ACGGAAGTCCGCACTT	ExciteL4
ACGGAAGTCGAACCAT	MOLs
ACGGAAGTCTCGTCAC	ExciteL4
ACGGGTCCACCCGTAG	ExciteL4
ACGGGTCCATCCTTCG	ExciteL4
ACGGGTCTCCCAAGCG	ExciteL4
ACGGTCGAGATTGAGT	MOLs
ACGGTCGGTGGGCTCT	MOLs
ACGGTCGTCCAATCTT	Astrocytes
ACGGTCGTCTGCGGGT	ExciteL6
ACGGTTAAGGCTCTAT	Microglia
ACGGTTACAAATACAG	MOLs
ACGGTTAGTAATTGGA	ExciteL5
ACGGTTAGTAGCTAAA	InhibNeuron
ACGGTTAGTTCAAACC	InhibNeuron
ACGGTTATCCAAGGGA	OPCs
ACGGTTATCCCTCTAG	ExciteL4
ACGGTTATCGTAGGAG	InhibNeuron
ACGTAACAGTTCATGC	MOLs
ACGTAACCATTGCTTT	Pericytes
ACGTAACGTTTGGAAA	Astrocytes
ACGTACAAGGTAATCA	ExciteL4
ACGTAGTAGTAGGAAG	ExciteL4
ACGTAGTCACGAGAAC	Microglia
ACGTAGTCAGTGAGCA	Astrocytes
ACGTAGTGTATCGTGT	MOLs
ACGTAGTGTATGTCCA	ExciteL5
ACGTAGTGTCACTGAT	Astrocytes
ACGTAGTTCATGGATC	InhibNeuron
ACGTCCTAGGATACGC	InhibNeuron
ACGTCCTAGTAACGAT	ExciteL4
ACGTCCTCAACCGCTG	ExciteL5
ACGTCCTGTGCGAGTA	OPCs
ACGTTCCCAGAGCTAG	ExciteL5
ACGTTCCTCCTGTAGA	Microglia
ACTACGACACCAATTG	ExciteL6
ACTACGACAGGTCAGA	Microglia
ACTATCTAGCTTCGTA	NIPCs
ACTATCTAGTAGACAT	Microglia
ACTATCTCACATGTTG	COPs
ACTATCTGTGATTAGA	Astrocytes
ACTATCTTCGTGTGAT	ExciteL5
ACTATCTTCTATTTCG	MOLs
ACTATGGCACCAAATC	MOLs
ACTATGGCATCCGGCA	OPCs
ACTATGGCATCCTTCG	MOLs
ACTATGGGTAAGACCG	ExciteL4
ACTATTCCACAGAGAC	MOLs
ACTATTCGTTCTCTCG	MOLs
ACTCCCAAGCACGATG	ExciteL6
ACTCCCACATCATGAC	Astrocytes
ACTCCCACATCCGTGG	MOLs
ACTCCCATCGACGATT	ExciteL4
ACTCTCGCACGTTCGG	ExciteL6
ACTCTCGCACTACGGC	ExciteL4
ACTCTCGGTATGTCCA	ExciteL23
ACTCTCGTCTGTCTCG	MOLs
ACTGATGCATCCGTTC	ExciteL4
ACTGATGGTGATAGAT	Macrophages
ACTGCAAAGGATATGT	Microglia
ACTGCAAAGGTAACTA	MOLs
ACTGCAACACACACTA	Microglia
ACTGCAAGTCCGATCG	MOLs
ACTGCAAGTGTGTGTT	ExciteL4
ACTGCAATCACAGAGG	ExciteL6
ACTGTCCCACAGGATG	Astrocytes
ACTGTCCTCCAACACA	OPCs
ACTGTGAAGTGCGCTC	InhibNeuron
ACTGTGACAATCAGCT	ExciteL4
ACTGTGAGTAGATGTA	MOLs
ACTGTGAGTATTTCGG	MOLs
ACTGTGATCACAAGAA	InhibNeuron
ACTGTGATCCATCAGA	ExciteL4
ACTGTGATCTGCGTCT	ExciteL4
ACTTAGGGTCCCTGTT	Macrophages
ACTTATCAGGTCGTGA	MOLs
ACTTATCGTCCCGTGA	ExciteL4
ACTTATCGTGGTTTAC	Macrophages
ACTTATCTCAGAGTGG	Macrophages
ACTTATCTCTGATTCT	ExciteNP
ACTTCCGAGCAACAGC	OPCs
ACTTCCGAGTCGAATA	Astrocytes
ACTTCCGAGTGCACTT	ExciteL4
ACTTCCGGTACCCAGC	ExciteL6
ACTTCCGGTATGAGAT	OPCs
ACTTCCGTCATAAGGA	InhibNeuron
ACTTCGCAGACCGCCT	MOLs
ACTTCGCAGCCGGAAT	Microglia
ACTTCGCAGGCACCAA	ExciteNP
ACTTCGCAGGTGGCTA	ExciteL6
ACTTCGCCAGGACAGT	ExciteL4
ACTTCGCCATCCTGTC	ExciteL4
ACTTCGCGTATGTCCA	ExciteL5
ACTTTCAAGGGAGGAC	OPCs
ACTTTCACAACTTCTT	MOLs
ACTTTCACAATGGGTG	COPs
ACTTTCACAGCTCTGG	ExciteL5
ACTTTCACATTGACTG	MOLs
ACTTTCATCCACGAAT	ExciteL6
ACTTTCATCGTGTTCC	ExciteL4
ACTTTGTAGTATGATG	ExciteL6
ACTTTGTGTCGAGTTT	OPCs
AGAAATGAGTCACTGT	ExciteL6
AGAAATGCACCTATCC	ExciteL4
AGAAATGGTCATAACC	InhibNeuron
AGAAATGGTGGCTGAA	ExciteL6
AGAAATGTCTATCGGA	ExciteL6
AGAACAAAGAGTCTGG	ExciteL4
AGAACAAAGCTCGACC	OPCs
AGAACAATCAAGTGTC	Pericytes
AGAACAATCTAGAACC	ExciteL5
AGAACAATCTGAGAGG	MOLs
AGAACCTAGGGAGGAC	Microglia
AGAACCTAGGTAGTAT	Astrocytes
AGAACCTCAGGCTTGC	ExciteL4
AGAACCTTCGCTTGAA	Microglia
AGAAGTAAGACCAGAC	ExciteL4
AGAAGTAAGGCTAACG	ExciteL4
AGAAGTAGTATGCGGA	Pericytes
AGAAGTATCCATGAGT	ExciteNP
AGACAAAAGGCGTCCT	Astrocytes
AGACAAACAGGTATGG	ExciteL4
AGACAAAGTAGCACAG	MOLs
AGACAAATCATTGAGC	MOLs
AGACAAATCCGCGGAT	ExciteL6
AGACACTCAAACCATC	MOLs
AGACACTCAGTAGAAT	Microglia
AGACACTTCTGACAGT	MOLs
AGACAGGGTATGAAAC	ExciteL6
AGACAGGTCACGGACC	Macrophages
AGACAGGTCCCTCTCC	ExciteNP
AGACCATCAGTAGGAC	ExciteL4
AGACCATCATAGACTC	ExciteL4
AGACCATTCTACCTTA	MOLs
AGACCCGAGTAAACTG	InhibNeuron
AGACCCGGTAGGAAAG	ExciteL23
AGACCCGTCTGCCCTA	ExciteL4
AGACTCAGTCACTCAA	ExciteL4
AGAGAATAGCTACTGT	ExciteL4
AGAGAATCATGACTAC	InhibNeuron
AGAGAATGTGCATACT	Astrocytes
AGAGAATGTTACGTAC	Microglia
AGAGAATTCCTGGGAC	ExciteL6
AGAGAGCAGCCTTTGA	ExciteNP
AGAGAGCCACTCTCGT	Microglia
AGAGAGCGTGCTTCAA	ExciteL4
AGAGAGCGTTACCCTC	ExciteL23
AGAGAGCTCAGACCCG	NIPCs
AGAGCAGAGGAGCAAA	ExciteL4
AGAGCAGCACGTATAC	ExciteL4
AGAGCAGGTCACGTGC	Astrocytes
AGAGCAGGTGTAAATG	OPCs
AGAGCAGTCATTCCTA	Macrophages
AGAGCCCGTCCGCAGT	MOLs
AGAGCCCGTTTCGGCG	ExciteL6
AGAGCCCTCACTCGAA	ExciteL23
AGAGCCCTCATCTATC	MOLs
AGATAGAAGGATGTTA	Microglia
AGATAGAAGTTCTCTT	MOLs
AGATAGACAAGTGACG	Microglia
AGATAGATCATCTGTT	ExciteL6
AGATAGATCCTGTTGC	Microglia
AGATCCACACAAATGA	ExciteL4
AGATCCACATCGCTAA	Microglia
AGATCCATCCGTCCTA	OPCs
AGATCGTGTCTGTAAC	ExciteL6
AGATGAAAGCGACATG	ExciteL6
AGATGAACAATCGCAT	ExciteL6
AGATGAAGTACTCAAC	MOLs
AGATGAAGTGCCTGCA	ExciteL6
AGATGCTAGGTCCAGA	ExciteL23
AGATGCTGTCTGTGCG	Astrocytes
AGATGCTGTTCGGGTC	MOLs
AGATGCTGTTCGTTCC	MOLs
AGATGCTGTTGCGAAG	ExciteL4
AGATGCTTCGTCCTCA	ExciteL4
AGCATCAAGCAAATCA	MOLs
AGCATCACAGAATGTA	ExciteL6
AGCATCATCCTCACTG	ExciteL4
AGCCAATAGCCTCAGC	NIPCs
AGCCAATAGCGAGTCA	OPCs
AGCCAATCAGCCGTCA	MOLs
AGCCAATCAGGTACGA	MOLs
AGCCAATCAGGTGTTT	ExciteL5
AGCCAATCATGCGGTC	MOLs
AGCCAATTCACTCCGT	ExciteL4
AGCCACGGTAGGCAGT	Microglia
AGCCACGGTGGCATCC	MOLs
AGCCACGGTGTGGTCC	ExciteNP
AGCCACGGTTTGACAC	ExciteL4
AGCCACGTCAACTGGT	ExciteNP
AGCCAGCAGAGTCGAC	MOLs
AGCCAGCAGTATAGAC	ExciteL6
AGCCAGCAGTCATCGT	ExciteL4
AGCCAGCAGTGCTAGG	MOLs
AGCCAGCGTTATTCTC	ExciteL5
AGCCAGCGTTGGAGAC	ExciteL4
AGCGATTAGGGAGGGT	Macrophages
AGCGATTCACAAGTTC	MOLs
AGCGATTCACCAGCGT	ExciteL4
AGCGCCACATACAGCT	Microglia
AGCGCCAGTCTTCTAT	ExciteL4
AGCGCCAGTGTTATCG	InhibNeuron
AGCGCCATCAACGAGG	ExciteL4
AGCGCTGAGTACGAGC	OPCs
AGCGCTGCACAAGTTC	OPCs
AGCGCTGCACTAACCA	ExciteNP
AGCGCTGGTAACAGTA	MOLs
AGCGCTGGTCCGTTTC	InhibNeuron
AGCGCTGTCTAGGAAA	ExciteL4
AGCGCTGTCTTCGGTC	ExciteL6
AGCGTATGTACAGAGC	ExciteNP
AGCGTATGTGCCAAGA	OPCs
AGCGTATTCTACCAGA	Pericytes
AGCGTCGCACACAGAG	ExciteL4
AGCTACACATCATTGG	Astrocytes
AGCTACAGTCGCAGTC	MOLs
AGCTACAGTCGTTGCG	ExciteL6
AGCTACAGTGGGACAT	ExciteL4
AGCTACAGTTGTGTAC	ExciteL6
AGCTACATCCGACAGC	ExciteL4
AGCTCAACATTCGATG	ExciteL6
AGCTCAAGTCAAAGTA	Pericytes
AGCTCAAGTCTGTAAC	ExciteL6
AGCTTCCAGGTCATTC	ExciteL4
AGCTTCCCAACGGTAG	ExciteL4
AGCTTCCGTCGCACGT	ExciteL4
AGCTTCCGTGTGAATA	ExciteL6
AGCTTCCTCATTTGCT	ExciteNP
AGCTTCCTCCCATGGG	ExciteL5
AGCTTCCTCTGAGGTT	ExciteL23
AGCTTCCTCTGCATAG	ExciteL6
AGGAAATAGCACCCAC	Astrocytes
AGGAAATAGGCCTGAA	ExciteL4
AGGAAATTCACCGCTT	ExciteL4
AGGAAATTCCGCTGTT	ExciteL5
AGGAATACAGACAATA	MOLs
AGGAATACAGGTAGTG	ExciteL4
AGGAATAGTACGGGAT	ExciteL6
AGGAATATCTGCTCTG	Macrophages
AGGACGAAGAGCATAT	MOLs
AGGACGAGTTTGTGGT	InhibNeuron
AGGACTTAGATGTTAG	MOLs
AGGACTTCAAGGCTTT	Microglia
AGGACTTCACAGCCAC	ExciteL4
AGGACTTCAGAGGAAA	OPCs
AGGACTTCAGAGTTCT	ExciteL6
AGGACTTTCTGGGCCA	ExciteL5
AGGAGGTTCGCATTGA	ExciteL5
AGGAGGTTCTTCTGGC	ExciteL4
AGGATAACACCTAAAC	ExciteL4
AGGATAACACGGTGTC	ExciteL6
AGGATAAGTGTAAACA	ExciteL6
AGGATAATCATATGGC	ExciteL4
AGGATCTAGCCTCACG	MOLs
AGGATCTAGCTATCCA	MOLs
AGGATCTAGTAGAATC	MOLs
AGGATCTTCAATCTCT	COPs
AGGATCTTCCGATGCG	MOLs
AGGATCTTCTCTTGCG	Microglia
AGGCATTAGTTCCATG	ExciteL4
AGGCATTGTCAGTCTA	ExciteL6
AGGCATTTCATTGTGG	ExciteL6
AGGCCACAGTGGTTCT	Microglia
AGGCCACCACATTCTT	Astrocytes
AGGCTGCAGCGCCCAT	Microglia
AGGCTGCCACCAGTTA	MOLs
AGGCTGCCAGACCAAG	OPCs
AGGGAGTGTACTGTTG	ExciteL4
AGGGAGTGTGCATTAC	ExciteL4
AGGGAGTTCGTGAGAG	ExciteL4
AGGGCCTAGGAAACGA	MOLs
AGGGCCTCATACATCG	ExciteL4
AGGGCCTCATGTTCAG	ExciteL6
AGGGCCTTCCAGTGTA	InhibNeuron
AGGGCCTTCTAGACCA	ExciteL6
AGGGCTCGTCCACTTC	MOLs
AGGGCTCGTGGGTATG	ExciteL6
AGGGCTCTCGCGTGAC	MOLs
AGGGTCCTCGAAGTGG	Astrocytes
AGGGTCCTCTCTCTAA	InhibNeuron
AGGGTGAAGAGATGCC	ExciteNP
AGGGTGACAAGAATGT	MOLs
AGGGTGACAAGATTGA	COPs
AGGGTGACAATAGTCC	OPCs
AGGGTGAGTCTAGGCC	MOLs
AGGGTGAGTGGAGAAA	OPCs
AGGGTGAGTTGGGAAC	ExciteL6
AGGGTGAGTTTGACAC	Microglia
AGGGTTTAGACGCTCC	ExciteL6
AGGGTTTCACACTTAG	MOLs
AGGGTTTCAGCAGAAC	Microglia
AGGGTTTGTCTACAGT	MOLs
AGGGTTTGTGGACTAG	ExciteL6
AGGGTTTGTTCTGAGT	ExciteL4
AGGGTTTTCCTCACGT	ExciteL5
AGGTAGGAGAGTGGCT	ExciteL4
AGGTAGGAGTTAACGA	MOLs
AGGTAGGCACCCTATC	ExciteL4
AGGTAGGTCGGCTTCT	ExciteL6
AGGTCATCACGCCACA	MOLs
AGGTCATGTTTCCCAC	ExciteL6
AGGTCTAAGGACGCAT	Macrophages
AGGTCTAAGTGCAGCA	Pericytes
AGGTCTACACCGTCGA	ExciteL4
AGGTCTACAGGCTATT	Microglia
AGGTCTAGTACGTTCA	ExciteL6
AGGTCTATCGATACAC	MOLs
AGGTCTATCGGAATTC	Microglia
AGGTGTTAGAATTCAG	ExciteL23
AGGTGTTAGCAGTAAT	ExciteL6
AGGTGTTGTAATCAGA	OPCs
AGGTTACAGAAGGGAT	Microglia
AGGTTACCAATAGAGT	MOLs
AGGTTACGTAGCTGAG	MOLs
AGGTTACGTGTTGATC	ExciteL5
AGGTTACTCCTCTGCA	MOLs
AGGTTGTAGTAACGAT	ExciteL4
AGGTTGTCACAGTGTT	ExciteL4
AGGTTGTGTCATATGC	ExciteL4
AGTAACCAGCGGGTAT	ExciteL6
AGTAACCAGTGAGTTA	ExciteL6
AGTAACCCAACGATTC	Microglia
AGTAACCCAATAACGA	Macrophages
AGTAACCCACATGGTT	ExciteL6
AGTAACCGTCCGGTCA	ExciteL23
AGTAACCGTGAGGCAT	MOLs
AGTAACCGTTAGGGAC	ExciteL23
AGTAACCTCGTGCACG	MOLs
AGTACCACAGGTACGA	MOLs
AGTACCAGTATCACGT	MOLs
AGTACCATCTCTAGGA	ExciteL6
AGTACTGCATGGCTGC	MOLs
AGTACTGTCATTCATC	MOLs
AGTACTGTCTTTGATC	OPCs
AGTAGCTAGATGACCG	ExciteL6
AGTAGCTAGTTGGCGA	ExciteL4
AGTAGCTCACTACTTT	ExciteL23
AGTAGCTGTCTAGTGT	MOLs
AGTAGCTTCACGGAGA	ExciteL6
AGTAGCTTCCCAGGCA	ExciteL4
AGTAGCTTCGATTGGT	ExciteL5
AGTAGCTTCTCTAGGA	ExciteL4
AGTAGTCCAAGGTCAG	ExciteL4
AGTAGTCGTGCAGTGA	MOLs
AGTAGTCTCCGATGTA	MOLs
AGTCAACCACTGGCCA	Microglia
AGTCAACCAGCATGCC	Macrophages
AGTCAACTCGTACACA	InhibNeuron
AGTCACAAGGTCACTT	ExciteL4
AGTCACAAGGTTGTTC	ExciteL6
AGTCACAAGTGTTGTC	Microglia
AGTCACATCGGTGTTA	ExciteL4
AGTCACATCTGGGTCG	ExciteL6
AGTCACATCTTCCCAG	Macrophages
AGTCATGAGATTGCGG	ExciteNP
AGTCATGCAAGAGGCT	MOLs
AGTCATGTCTCGGTAA	ExciteL6
AGTCTCCAGCAACCAG	MOLs
AGTCTCCCACGCGCTA	MOLs
AGTCTCCGTTCTCTCG	MOLs
AGTCTCCTCATTTGGG	ExciteL4
AGTCTCCTCCGTTGGG	MOLs
AGTCTCCTCTGCGAGC	MOLs
AGTGACTAGAGTCAAT	ExciteL6
AGTGACTAGCGTCGAA	Microglia
AGTGACTCAGCCCACA	InhibNeuron
AGTGACTGTCCATCTC	MOLs
AGTGACTTCATGCGGC	OPCs
AGTGACTTCGAAGCCC	NIPCs
AGTGATCAGGTATCTC	Microglia
AGTGATCAGGTGGGTT	OPCs
AGTGCCGAGTCGAGGT	InhibNeuron
AGTGCCGCAATCTCGA	Microglia
AGTGCCGGTTATCCAG	ExciteL6
AGTGCCGTCTGGGCAC	ExciteL4
AGTGCCGTCTTCGTGC	OPCs
AGTGTTGAGAGGCGGA	OPCs
AGTGTTGAGATCACCT	ExciteL4
AGTTAGCAGACCATGG	ExciteL6
AGTTAGCCATAGAGGC	ExciteL6
AGTTAGCGTCCAGAAG	OPCs
AGTTCCCAGTACTGGG	MOLs
AGTTCCCCAGCGACCT	MOLs
AGTTCCCCAGGCTATT	MOLs
AGTTCCCCAGTTGTCA	MOLs
AGTTCCCGTTCCACAA	ExciteL6
AGTTCGAAGCCTAACT	ExciteL4
AGTTCGATCACCACAA	InhibNeuron
AGTTCGATCGCATTAG	ExciteL4
ATACCGAAGAGGATGA	ExciteL6
ATACCGACACGAGGAT	MOLs
ATACCGACATCTCCCA	MOLs
ATACCGACATGTGCCG	Microglia
ATACCTTAGTTACGTC	Astrocytes
ATACCTTCAGCTGTAT	ExciteL4
ATACCTTCAGGCGATA	InhibNeuron
ATACCTTCATTGCTTT	ExciteL4
ATACCTTTCCTCAGAA	ExciteL4
ATACTTCCATCGTGGC	ExciteL6
ATAGACCAGAGTGACC	MOLs
ATAGACCAGCGTGAGT	ExciteL6
ATAGACCCAAATGATG	ExciteL4
ATAGACCCAATGTTGC	OPCs
ATAGACCGTTCTTCAT	MOLs
ATAGACCTCCACAGCG	Astrocytes
ATAGACCTCTACGCGG	ExciteL5
ATAGAGAAGACTTAAG	ExciteL4
ATAGAGAAGGCTTAAA	ExciteL4
ATAGAGACATGACTTG	OPCs
ATAGAGACATTGTACG	Astrocytes
ATAGAGAGTCAATGGG	ExciteL4
ATAGAGAGTCTGTAGT	MOLs
ATAGAGATCGAGATGG	ExciteL6
ATAGGCTAGAGTCCGA	ExciteL6
ATAGGCTAGCTATCCA	Macrophages
ATAGGCTCAAGCCCAC	Pericytes
ATAGGCTCACTACGGC	ExciteL6
ATAGGCTGTCCTTTGC	ExciteL6
ATAGGCTGTTCAATCG	ExciteL4
ATAGGCTGTTTAAGGA	Pericytes
ATAGGCTTCGACATAC	Microglia
ATAGGCTTCTCCGAGG	ExciteL6
ATATCCTAGGGTCAAC	MOLs
ATATCCTTCGGACTGC	Pericytes
ATATCCTTCGTTCATT	ExciteL4
ATCACAGAGGGTTAAT	InhibNeuron
ATCACAGTCAAGTCTG	MOLs
ATCACAGTCATGAAAG	MOLs
ATCACAGTCCGTTGAA	ExciteL6
ATCACGACAGCAATTC	Microglia
ATCACGAGTGACTCGC	Microglia
ATCACGATCATGGAGG	ExciteL6
ATCACTTCACATATGC	ExciteL6
ATCAGGTAGAGCTGCA	MOLs
ATCAGGTCAGGTTACT	MOLs
ATCAGGTCATAGGTAA	ExciteL4
ATCAGGTCATCCCGTT	MOLs
ATCAGGTCATCCTGTC	ExciteL6
ATCAGGTGTCTGATCA	Endo
ATCAGGTTCCGATCGG	ExciteL5
ATCAGGTTCTGGACTA	ExciteL4
ATCATTCAGGAACTCG	MOLs
ATCATTCGTCGCGTTG	MOLs
ATCCACCCATCGATAC	MOLs
ATCCACCGTCAACCAT	Endo
ATCCACCGTGTTCGAT	MOLs
ATCCATTAGCAAACAT	ExciteL6
ATCCATTAGGCATCTT	Astrocytes
ATCCATTAGTCCGCCA	ExciteL6
ATCCATTAGTGTACAA	ExciteL6
ATCCATTCAAGGGTCA	ExciteL6
ATCCATTGTTTATGCG	MOLs
ATCCATTTCTCAACCC	ExciteL4
ATCCCTGCACTGTGAT	MOLs
ATCCCTGTCCCTTGTG	ExciteL4
ATCCCTGTCGCACTCT	MOLs
ATCCCTGTCGCTAATG	COPs
ATCCGTCCAGTTACCA	ExciteL4
ATCCGTCCATTGTACG	MOLs
ATCCGTCTCATCGACA	Astrocytes
ATCCGTCTCTGCGTCT	Microglia
ATCCTATCAATACCTG	ExciteL4
ATCCTATGTCACTTAG	ExciteL6
ATCCTATGTTTCGACA	ExciteL6
ATCGATGAGCACGATG	ExciteL6
ATCGATGCAATAGTAG	ExciteL4
ATCGATGCATGAGAAT	InhibNeuron
ATCGATGCATTAGGAA	MOLs
ATCGATGGTAGAGGAA	InhibNeuron
ATCGATGGTATGACAA	ExciteL6
ATCGCCTCAATCTAGC	ExciteL6
ATCGCCTCACATAACC	ExciteL4
ATCGCCTCAGATACCT	ExciteL6
ATCGCCTCAGTCGGTC	MOLs
ATCGGATAGACTCTTG	MOLs
ATCGGCGAGAGAGGGC	MOLs
ATCGGCGCAAACCACT	Astrocytes
ATCGGCGGTAGACGTG	ExciteL4
ATCGTAGAGACGCATG	MOLs
ATCGTAGCACCTCGTT	Macrophages
ATCGTAGCACGTGTGC	Astrocytes
ATCGTCCAGAGACAAG	ExciteL6
ATCGTGAAGATTCGAA	OPCs
ATCGTGAAGTGCCGAA	ExciteL4
ATCGTGACAGATCACT	ExciteL23
ATCGTGATCATCGCAA	ExciteL6
ATCGTGATCTCGTGGG	ExciteL4
ATCTCTAAGCACACAG	ExciteNP
ATCTCTACACTCCGGA	Microglia
ATCTCTACAGAGCCCT	MOLs
ATCTCTATCAGCGGAA	ExciteL4
ATCTCTATCATACGAC	OPCs
ATCTCTATCTGAGGCC	ExciteL4
ATCTTCAAGACGACTG	Pericytes
ATCTTCACAGCTCGGT	ExciteL6
ATGAAAGCAACGGTAG	Microglia
ATGAAAGGTGGTCCCA	MOLs
ATGAAAGTCGGATACT	ExciteL4
ATGAAAGTCGTCGATA	MFOLs
ATGACCAGTCGATGCC	MOLs
ATGACCAGTCTCTCTG	ExciteL4
ATGAGGGGTTCATCTT	ExciteL6
ATGAGGGTCAAAGACA	ExciteL6
ATGAGGGTCAACGTGT	ExciteL6
ATGAGGGTCGAATCCA	ExciteL4
ATGAGGGTCTCGTCAC	ExciteL4
ATGAGGGTCTCTTCAA	ExciteL4
ATGAGTCAGTTCTACG	ExciteL4
ATGAGTCCAGCAATTC	Microglia
ATGAGTCCATTGCCTC	ExciteL4
ATGAGTCGTACGATGG	ExciteL4
ATGATCGAGCCTCTTC	Astrocytes
ATGATCGCAGCTGAGA	Astrocytes
ATGATCGGTCTGTGCG	MOLs
ATGATCGTCTCCGAGG	Astrocytes
ATGCATGGTGGCTTGC	ExciteL6
ATGCATGTCAATCCAG	Microglia
ATGCATGTCCTAGCGG	ExciteL6
ATGCATGTCGCTCATC	ExciteL4
ATGCATGTCTTCCCGA	ExciteL4
ATGCCTCAGGAGAATG	ExciteL6
ATGCCTCAGTATGCAA	MOLs
ATGCCTCTCCGTATAG	ExciteL5
ATGCGATAGTCTGTAC	ExciteL6
ATGCGATCAAGTGGGT	Pericytes
ATGCGATCACGTCTCT	ExciteL4
ATGCGATTCGGCTGTG	ExciteL4
ATGGAGGCATTGACTG	Astrocytes
ATGGAGGGTCGGAACA	InhibNeuron
ATGGATCAGACTAGAT	MOLs
ATGGATCCAAATGCTC	MOLs
ATGGATCCACGCGTCA	ExciteL4
ATGGGAGAGCTACAAA	ExciteL23
ATGGGAGAGGGAGGAC	Microglia
ATGGGAGAGGTCCAGA	ExciteL4
ATGGGAGGTGCCGTTG	Pericytes
ATGGGAGTCCACTTTA	ExciteL6
ATGGGTTAGGAAGTAG	MOLs
ATGGGTTCAAGGACAC	Macrophages
ATGGGTTCACTGTGTA	MOLs
ATGGTTGAGAGTGTTA	ExciteL6
ATGGTTGAGTATAACG	ExciteL4
ATGGTTGAGTTGAAAC	Microglia
ATGGTTGGTCTAACTG	Astrocytes
ATGGTTGGTGACCGAA	MOLs
ATGGTTGGTGCCGGTT	ExciteL6
ATGTCCCGTAACGATA	MOLs
ATGTCCCGTCAACCAT	ExciteL5
ATGTCCCGTTCGAACT	MFOLs
ATGTCTTAGGCAGCTA	MOLs
ATGTCTTCACACTGGC	ExciteL4
ATGTCTTCATCCTAAG	Astrocytes
ATGTCTTGTAACAAGT	MOLs
ATGTCTTGTATATGGA	ExciteL4
ATGTCTTGTTGTTGAC	ExciteL6
ATGTCTTTCACCGCTT	ExciteL6
ATTACCTGTTGGAGAC	ExciteL6
ATTACTCAGAGGATCC	ExciteL4
ATTACTCGTCAGGCAA	Microglia
ATTATCCAGTGCCAGA	ExciteL23
ATTATCCCAAAGGCGT	ExciteL6
ATTATCCGTAGTGATA	ExciteL4
ATTATCCGTTCTCGCT	Microglia
ATTATCCTCCGCAACG	ExciteL6
ATTATCCTCGCCTCTA	ExciteL6
ATTATCCTCTCTTCAA	MOLs
ATTCACTAGCGCGTTC	Macrophages
ATTCACTAGGATGAGA	MOLs
ATTCACTAGGGAGATA	OPCs
ATTCACTAGTTGGAAT	Microglia
ATTCACTCAAAGAGTT	ExciteL4
ATTCACTGTGTCCGTG	ExciteL5
ATTCAGGAGTCCTGTA	ExciteL4
ATTCAGGCAGCGTTTA	InhibNeuron
ATTCAGGGTGTGTCCG	NIPCs
ATTCAGGTCAAGTCTG	ExciteL4
ATTCAGGTCCGATCTC	MOLs
ATTCAGGTCCTAGAGT	ExciteL4
ATTCATCAGACGTCGA	ExciteL23
ATTCATCGTTCCCAAA	ExciteL4
ATTCATCTCCGCACGA	Microglia
ATTCATCTCCGCTAGG	Astrocytes
ATTCATCTCTTACGTT	ExciteL6
ATTCCATCAGCTACAT	ExciteL4
ATTCCATGTGGCTTAT	ExciteL4
ATTCCATGTTAAGACA	InhibNeuron
ATTCCATTCAAGCGTT	Microglia
ATTCCATTCAGCCCAG	ExciteL5
ATTCCATTCATTGGTG	ExciteL23
ATTCCCGTCATGAAAG	ExciteL5
ATTCCCGTCGAGTCTA	ExciteL6
ATTCCTAGTTCTCTCG	OPCs
ATTCCTATCCAACTGA	MOLs
ATTCGTTAGCCATTTG	MOLs
ATTCGTTAGGTCCAGA	ExciteNP
ATTCGTTCACTAAACC	ExciteL4
ATTCGTTCATACCAGT	Astrocytes
ATTCGTTGTGATCGTT	Astrocytes
ATTCGTTTCTAGCCTC	ExciteL5
ATTCTACCACAGCCTG	Astrocytes
ATTCTACGTAACATGA	ExciteL4
ATTCTACGTATCAGCT	OPCs
ATTCTACGTTAAGACA	ExciteL23
ATTCTTGAGACATCAA	ExciteL6
ATTCTTGCACAGCTTA	ExciteL5
ATTCTTGGTGTATTCG	ExciteL6
ATTGGGTAGGAATCGC	OPCs
ATTGGGTCAAAGCAAT	InhibNeuron
ATTGGGTCAACTGAAA	MOLs
ATTGGGTCAGACCCGT	OPCs
ATTGGGTGTACTAAGA	ExciteL6
ATTGGGTGTGCCTGCA	Microglia
ATTGTTCAGAAGCGCT	Pericytes
ATTGTTCAGCGTCAGA	ExciteL6
ATTGTTCAGTGGTGAC	ExciteL6
ATTGTTCGTAGACGGT	ExciteL6
ATTGTTCTCGTTGCCT	InhibNeuron
ATTGTTCTCTTCCTAA	ExciteL6
ATTTACCAGCGAGTAC	ExciteL6
ATTTACCAGTGATAGT	InhibNeuron
ATTTACCGTGAGCAGT	ExciteL6
ATTTACCTCAATGCAC	MOLs
ATTTCACCAATTGGTC	ExciteL6
ATTTCTGTCAGATGCT	OPCs
ATTTCTGTCTCGCTCA	MOLs
ATTTCTGTCTGCATGA	MOLs
CAAAGAACAGGCCTGT	ExciteL6
CAAAGAAGTAGGAGTC	ExciteL6
CAAAGAAGTATCTCGA	OPCs
CAAAGAAGTGTCTTGA	ExciteL4
CAAAGAATCTCTGCCA	MOLs
CAACAACAGGGCTAAC	ExciteL6
CAACAACCAAAGGCGT	ExciteL4
CAACAACCACACCTGG	ExciteL6
CAACAACCATTGCAAC	MOLs
CAACAACGTATGGGAC	ExciteL4
CAACAGTAGTTTCTTC	MOLs
CAACAGTCAGCCCACA	Macrophages
CAACAGTCAGGTCAAG	ExciteL4
CAACAGTGTCGCATTA	ExciteL6
CAACCAAAGACCACGA	ExciteL5
CAACCAAAGATAGTGT	MOLs
CAACCAAAGGGTACGT	ExciteL6
CAACCAAAGGTAGTAT	Astrocytes
CAACCAACAATCTCTT	Astrocytes
CAACCAAGTCTCACGG	ExciteL6
CAACCAAGTTTGAACC	ExciteL4
CAACCAATCTATGTGG	ExciteL6
CAACCAATCTTGGCTC	OPCs
CAACCTCCATAGGCGA	ExciteL6
CAACCTCGTCTTCCGT	ExciteL4
CAACCTCGTGTGCCTG	Microglia
CAACCTCTCCATCACC	ExciteL4
CAACGATCATCCTTCG	ExciteL23
CAACGATTCACTCACC	InhibNeuron
CAACGATTCAGCTGTA	MOLs
CAACGGCAGCAGCCTC	InhibNeuron
CAACGGCAGTAGTCAA	MOLs
CAACGGCCACCAGGTC	OPCs
CAACGGCCACGACAAG	MOLs
CAACGGCCAGAAGCTG	ExciteL6
CAACGGCCAGGTGTTT	Microglia
CAACGGCCAGTAACAA	Microglia
CAACGGCTCATCGCCT	ExciteL5
CAAGACTAGTCCCAAT	ExciteL4
CAAGACTCAAGCCATT	ExciteNP
CAAGACTCAGCTTTCC	Microglia
CAAGACTCATTGAAGA	MOLs
CAAGACTGTATCTTCT	ExciteL5
CAAGACTGTTGGTGTT	ExciteL4
CAAGACTTCCTACTGC	ExciteL6
CAAGAGGAGGAGATAG	Pericytes
CAAGAGGAGGATATGT	Astrocytes
CAAGAGGCAGTAGAAT	MFOLs
CAAGAGGTCGAGATAA	ExciteL6
CAAGCTAAGAAATTGC	MOLs
CAAGCTAAGTCATCCA	ExciteL4
CAAGCTAGTGTCATTG	Microglia
CAAGGGACAGCTTTGA	ExciteL6
CAAGGGAGTTCGAGCC	ExciteL4
CAAGGGAGTTGCATTG	ExciteL6
CAATACGGTACCCGCA	ExciteL4
CAATACGTCATTGCCC	ExciteNP
CAATCGAAGCCATTGT	ExciteL5
CAATCGAAGCCGAACA	OPCs
CAATCGAGTAGAGGAA	ExciteL6
CAATCGATCTGTCGTC	ExciteL6
CAATGACCAATGCAGG	Microglia
CAATGACGTTTACACG	ExciteNP
CAATTTCAGCCATATC	ExciteL6
CAATTTCAGTAGACAT	OPCs
CAATTTCGTTCTCGTC	ExciteL6
CACAACAAGGATTCAA	ExciteL4
CACAACAAGGCTGTAG	ExciteL6
CACAACAGTCTTGAGT	ExciteL4
CACAACAGTGTAAATG	Astrocytes
CACAACAGTTGCGAAG	ExciteL4
CACACAACAAGGATGC	ExciteL4
CACACAACACGCAAAG	ExciteL6
CACACAATCGTGCTCT	ExciteL23
CACAGATCACCCGTAG	ExciteL6
CACAGATGTAGTGCGA	ExciteL6
CACAGATGTGCCTATA	InhibNeuron
CACAGATTCGTACACA	OPCs
CACAGATTCTTGGCTC	OPCs
CACAGGCAGTCATGGG	ExciteL4
CACAGGCCAAGAGAGA	ExciteL6
CACAGGCGTGAGATCG	ExciteL6
CACAGGCGTTCTCTCG	InhibNeuron
CACAGGCTCCATTCGC	ExciteL4
CACAGGCTCGTGCACG	Microglia
CACATGAGTGTTGACT	ExciteNP
CACCAAAAGCACAAAT	MOLs
CACCAAAAGGAAGTAG	MOLs
CACCAAAAGGAATTAC	MOLs
CACCAAACACTCCGGA	Pericytes
CACCAAATCCTAGCCT	ExciteL4
CACCAAATCGAGAATA	Pericytes
CACCGTTAGATCACCT	Microglia
CACCGTTAGCCTATCA	ExciteNP
CACCGTTCAGTCGAGA	ExciteL6
CACCGTTTCGACGAGA	OPCs
CACCGTTTCTACGCGG	ExciteL4
CACGAATAGGGCAGGA	MOLs
CACGAATCAACCGCTG	OPCs
CACGAATCATGGAAGC	ExciteL4
CACGAATGTAATGTGA	ExciteL6
CACGAATTCAAGAGGC	Microglia
CACGAATTCGGACAAG	ExciteL6
CACGAATTCTCCGATC	ExciteL6
CACGGGTGTAAGCAAT	MOLs
CACGGGTGTCCCACGA	ExciteL6
CACGGGTGTGGCCCAT	Astrocytes
CACGTGGAGTAGTCAA	ExciteL4
CACGTGGCAACCTATG	MOLs
CACGTGGCAAGGTTGG	MFOLs
CACGTGGCATACTTTC	Microglia
CACGTGGGTTTACCTT	Macrophages
CACGTGGTCAGAACCT	ExciteL6
CACGTGGTCTCATAGG	ExciteL6
CACGTTCAGAAGTATC	ExciteL6
CACGTTCAGTTGCATC	ExciteNP
CACGTTCGTCATACCA	Pericytes
CACTAAGGTACTAACC	MOLs
CACTAAGTCGCTGCGA	Pericytes
CACTGAAAGATGTTAG	ExciteL4
CACTGAAAGCTTTGTG	ExciteL4
CACTGAAAGGGTCACA	OPCs
CACTGAACACCAAATC	MOLs
CACTGAATCAATCCGA	OPCs
CACTGAATCTGTTCAT	ExciteNP
CACTGGGAGCCTGAAG	ExciteL6
CACTGGGAGTAGGATT	ExciteL4
CACTGGGCACAAATCC	InhibNeuron
CACTGGGCAGCGTTTA	MOLs
CACTGGGGTGCATACT	ExciteL5
CACTGGGGTTAGTCGT	OPCs
CACTGGGTCATCCTGC	InhibNeuron
CACTGGGTCGCGGTAC	ExciteL6
CACTGTCAGAAATGGG	ExciteL6
CACTGTCGTAAGATCA	COPs
CACTGTCGTACCAGAG	ExciteL23
CACTTCGAGAAGCGGG	ExciteL23
CACTTCGAGTGGTCAG	ExciteL23
CACTTCGCATTGAAAG	ExciteL4
CACTTCGTCAGCAGAG	MOLs
CAGAGCCGTCCCTGAG	Pericytes
CAGAGCCGTGCCTACG	Microglia
CAGAGCCGTGCGTGCT	ExciteL6
CAGAGCCGTGGCTAGA	ExciteL6
CAGAGCCGTGTTAACC	ExciteL6
CAGATACAGAAGCTGC	MOLs
CAGATACCAGCTGCCA	Microglia
CAGATACCATAACGGG	ExciteL4
CAGATACGTCGCTTAA	Microglia
CAGATACGTCGTACTA	Pericytes
CAGATACGTCTTCATT	InhibNeuron
CAGATACTCGGAATTC	InhibNeuron
CAGATCAAGACGCCAA	Endo
CAGATCACACGTAGTT	ExciteL23
CAGATCACATCGGAGA	ExciteL4
CAGATCAGTGAATAAC	ExciteL4
CAGATCAGTGTTGAGG	ExciteL6
CAGATCATCATGCCGG	ExciteL4
CAGATCATCTCATTTG	InhibNeuron
CAGATCATCTGTCCGT	ExciteL4
CAGATTGAGGACTGGT	ExciteL5
CAGATTGCACGCTGTG	OPCs
CAGATTGGTACCTAAC	ExciteL4
CAGATTGGTGCTCTTC	MOLs
CAGATTGTCAGAGCAG	MOLs
CAGATTGTCCATAGGT	ExciteL4
CAGATTGTCGTCCATC	Microglia
CAGCAATCACATCATG	MOLs
CAGCAATGTATAGGAT	ExciteL6
CAGCAATGTGTTAAAG	ExciteL6
CAGCAATTCAATCTCT	MOLs
CAGCACGAGTAGCAAT	ExciteL4
CAGCAGCAGACATAGT	Microglia
CAGCAGCAGATTCGAA	Macrophages
CAGCAGCCAAAGGCGT	Astrocytes
CAGCAGCCAATGACCT	ExciteL4
CAGCAGCCAGTAGAGC	ExciteL6
CAGCCAGGTCCACGCA	ExciteL4
CAGCCAGGTGAACCGA	Microglia
CAGCCAGTCTTCTAAC	MOLs
CAGCGTGCAATGAGCG	Endo
CAGCGTGGTCCTCAGG	Pericytes
CAGGCCACACCTGAAT	ExciteL6
CAGGCCAGTGAGATCG	MOLs
CAGGCCAGTGTAACGG	ExciteL5
CAGGCCAGTTGTATGC	COPs
CAGGCCATCGTAACCA	InhibNeuron
CAGGGCTAGCTATCCA	MOLs
CAGGGCTAGGATTTGA	ExciteL4
CAGGGCTGTTCCTAAG	ExciteL5
CAGGTATAGAGGGTAA	ExciteL6
CAGGTATAGCTAATGA	ExciteL4
CAGGTATAGGGCATGT	ExciteL6
CAGGTATCAATCAGCT	ExciteL4
CAGGTATCACGATTCA	ExciteNP
CAGGTATGTAGTCCTA	MOLs
CAGGTATGTCAGGTAG	ExciteL6
CAGGTATGTTCAGGTT	MOLs
CAGGTATTCAGATTGC	ExciteNP
CAGTGCGAGACCTTTG	Pericytes
CAGTGCGAGCGCCTCA	ExciteL23
CAGTGCGCAGCGGTCT	MOLs
CAGTGCGCAGCTACTA	MOLs
CAGTGCGGTATCGTTG	ExciteL4
CAGTGCGGTTCAGCGC	ExciteL6
CAGTGCGTCAGTCTTT	ExciteL4
CAGTTAGCAACGACTT	ExciteL6
CAGTTAGCATTGTGCA	ExciteL4
CAGTTAGGTACATTGC	ExciteNP
CAGTTAGGTTCAAACC	Astrocytes
CAGTTCCAGGAGCTGT	ExciteL6
CAGTTCCGTATCAGGG	ExciteNP
CAGTTCCGTGACACGA	Microglia
CAGTTCCGTTCCCACT	MOLs
CAGTTCCTCGATTTCT	ExciteL4
CATAAGCAGGATGAGA	MOLs
CATAAGCAGTAAGACT	MOLs
CATAAGCCAGAGGGTT	ExciteL6
CATAAGCGTCGTCAGC	ExciteL6
CATAAGCTCCTTCGAC	Microglia
CATAAGCTCGGCTGGT	ExciteL6
CATACAGTCAGTCTTT	Microglia
CATACCCAGTAGTGCG	ExciteL4
CATACCCAGTCTAGAA	ExciteL6
CATACCCCAGCTCATA	ExciteL6
CATACCCGTGTTAACC	ExciteL4
CATACCCGTTATTCTC	ExciteL4
CATACCCTCGCGTTTC	ExciteL6
CATACTTAGATCGACG	ExciteL4
CATACTTAGTTCAACC	MOLs
CATACTTCACTACCGG	InhibNeuron
CATACTTCAGCCCAGT	ExciteL6
CATACTTTCCCAGTGG	ExciteL4
CATAGACAGCAACCAG	ExciteNP
CATAGACGTAGACGGT	MOLs
CATAGACTCACCCTCA	ExciteL6
CATCAAGCAGTCTTCC	ExciteL6
CATCAAGTCAGACCTA	ExciteL6
CATCAAGTCGCATTGA	ExciteL6
CATCCACAGGGTGAGG	ExciteL6
CATCCACAGGTCTTTG	InhibNeuron
CATCCACCACTTCAAG	MOLs
CATCCACCATGCCATA	InhibNeuron
CATCCACCATTGAAGA	ExciteL23
CATCCACGTACAGCGA	MOLs
CATCCACTCCTCGATC	ExciteL6
CATCCACTCGATTGGT	Microglia
CATCCACTCTGGGCAC	ExciteL4
CATCCCAAGGATTTGA	OPCs
CATCCCAGTTGTCCCT	ExciteL4
CATCCCATCGTAGCCG	ExciteNP
CATCCGTAGTATTCCG	OPCs
CATCCGTCACCCATAA	Astrocytes
CATCCGTCAGAGTGTG	ExciteL6
CATCGCTAGGTCATAA	MOLs
CATCGCTCACAAAGTA	Endo
CATCGCTCATGTCGTA	Microglia
CATCGCTGTACAGTAA	MOLs
CATCGCTGTCGGAAAC	InhibNeuron
CATCGCTGTTACAGCT	ExciteL23
CATCGGGCATTGGATC	InhibNeuron
CATCGGGTCAGGAAAT	MOLs
CATCGTCAGAGAGCGG	ExciteNP
CATCGTCAGAGTGGCT	ExciteL6
CATCGTCGTATGAAGT	Microglia
CATCGTCTCCACCTCA	InhibNeuron
CATCGTCTCGTAGCCG	ExciteL4
CATCGTCTCTACACTT	MOLs
CATGAGTAGTAGCATA	ExciteL6
CATGAGTCAAAGCGTG	ExciteL4
CATGAGTCAACAACAA	MOLs
CATGAGTCAGAGATGC	Microglia
CATGAGTGTACTGACT	ExciteL4
CATGAGTGTATACAGA	MOLs
CATGAGTTCAATCAGC	OPCs
CATGCAAAGATCACTC	InhibNeuron
CATGCAAAGTAATCCC	InhibNeuron
CATGCAACAATTGAGA	ExciteL6
CATGCAAGTCGTACTA	MFOLs
CATGCAAGTGACGTCC	InhibNeuron
CATGCAATCAGTCCGG	Microglia
CATGCCTAGCAGGCTA	ExciteL4
CATGCCTAGGAGCAAA	Pericytes
CATGCCTCACGCCACA	Astrocytes
CATGCCTCACTACACA	Pericytes
CATGCCTCAGGAGGTT	Microglia
CATGCCTTCTTCGATT	OPCs
CATGCGGAGGAGCAAA	ExciteL6
CATGCGGCAGGTCCGT	InhibNeuron
CATGCGGGTCAAAGAT	ExciteL6
CATGCGGGTGCCTAAT	Microglia
CATGCGGGTTTGACAC	MOLs
CATGCGGTCTTCGGAA	ExciteL4
CATGCTCAGGTTCTAC	Astrocytes
CATGCTCGTACTAACC	Pericytes
CATGCTCGTCTACACA	Microglia
CATGCTCTCACGAGGA	ExciteL4
CATGCTCTCCACCTGT	Microglia
CATGGATAGCGTATGG	ExciteL23
CATGGATCACACGGTC	MOLs
CATGGATGTAACATGA	MOLs
CATGGATGTGAACCGA	ExciteL4
CATGGATGTGCATGAG	Astrocytes
CATGGATGTTGTACGT	Pericytes
CATGGATTCAGCGTCG	ExciteL6
CATGGATTCTTCTGTA	OPCs
CATGGTAGTCGTGTTA	MOLs
CATGGTATCGTGGCTG	MOLs
CATGGTATCTCGGCTT	ExciteL6
CATGGTATCTTTCAGT	Astrocytes
CATTCATAGCTGTTCA	ExciteL4
CATTCATGTCGAAACG	MOLs
CATTCATGTCTACTGA	Microglia
CATTCCGCAACAAGAT	ExciteL6
CATTCCGCACGCGCTA	MOLs
CATTCTACAGTACTAC	MOLs
CATTCTACAGTTCACA	ExciteL6
CATTCTAGTGTTCCAA	Microglia
CATTCTATCGATACTG	MFOLs
CATTGAGAGGTCACAG	ExciteL4
CATTGCCAGCTCTTCC	Microglia
CATTGCCCATATGAAG	ExciteL6
CATTGCCTCCATCTAT	MOLs
CATTGTTAGAGAGCCT	ExciteL6
CATTGTTCAATCTGCA	ExciteL4
CATTGTTTCTTCTGTA	ExciteL5
CATTTCACATTGGATC	ExciteL4
CCAAGCGCAAAGACGC	MOLs
CCAAGCGTCGCTGATA	MFOLs
CCAATGAAGAGGCCAT	MOLs
CCAATGACAGATTAAG	Pericytes
CCAATGAGTCGCACAC	ExciteL4
CCAATTTAGGCTCTAT	Astrocytes
CCAATTTCAAAGTATG	Microglia
CCACAAACAAGACGAC	ExciteL4
CCACAAAGTACGATTC	ExciteL6
CCACAAAGTGTGAGCA	ExciteL6
CCACAAATCGTTCGCT	ExciteL4
CCACACTAGGGCTTCC	MOLs
CCACACTGTGTATTCG	MFOLs
CCACACTTCCGATGTA	Microglia
CCACCATAGGGAGGCA	Microglia
CCACCATAGTGAGTTA	MOLs
CCACCATCACAAATAG	ExciteL6
CCACCATGTTGCTGAT	InhibNeuron
CCACCATTCATGGAGG	ExciteL6
CCACCATTCTGGCTGG	OPCs
CCACGAGAGGCTGAAC	ExciteL5
CCACGAGAGTAACGAT	ExciteL4
CCACGAGCAATAACCC	ExciteL6
CCACGAGCATAACTCG	ExciteL6
CCACGAGTCAAGGACG	MOLs
CCACGAGTCTAGACAC	MOLs
CCACGTTAGGCATCAG	OPCs
CCACGTTCAAGAGCTG	MOLs
CCACGTTCAAGAGTGC	ExciteL4
CCACGTTGTACAAGCG	ExciteL6
CCACGTTGTCGCTGCA	MOLs
CCACGTTGTTCAAGGG	ExciteL4
CCACGTTTCATACGGT	ExciteL4
CCACTTGCAGAGACTG	ExciteL5
CCACTTGGTCAACCAT	Astrocytes
CCACTTGTCAAGCCCG	ExciteL6
CCACTTGTCGAGAACG	MOLs
CCACTTGTCGCATAGT	MOLs
CCACTTGTCGTGGCGT	ExciteL4
CCATAAGAGAGAGTGA	ExciteL6
CCATAAGCAAGTGCAG	ExciteL6
CCATAAGCAGAGTTCT	ExciteL5
CCATAAGGTGGTCTAT	Endo
CCATCACAGAGAGAAC	ExciteL4
CCATCACAGTATGATG	ExciteL6
CCATCACCAGCAAGAC	ExciteL6
CCATCACCATGACTGT	MOLs
CCATCACCATGGCCAC	ExciteL6
CCATCACGTCCGAAGA	Endo
CCATCACTCACTAGCA	Astrocytes
CCATCACTCTTGTTAC	ExciteL6
CCCAACTCAGAAACCG	ExciteL4
CCCAACTGTCGCGGTT	ExciteL4
CCCAACTTCAAGGAGC	InhibNeuron
CCCATTGTCAACTTTC	MOLs
CCCATTGTCTAGTCAG	Astrocytes
CCCATTGTCTTTCCAA	Microglia
CCCGAAGCAATGTCTG	MOLs
CCCGAAGCACCTCTGT	MOLs
CCCGAAGCACTCTGCT	ExciteL4
CCCGAAGGTGTGAATA	ExciteL4
CCCGAAGTCAGGGTAG	ExciteL4
CCCGGAACAGCACGAA	MOLs
CCCGGAACAGGTTCCG	ExciteNP
CCCGGAATCCATGATG	ExciteNP
CCCGGAATCGATGCAT	Astrocytes
CCCGGAATCTCCCATG	MOLs
CCCTAACCAGCCGTCA	ExciteL4
CCCTCAAAGGCAATGC	ExciteL4
CCCTCAACATCTCGTC	ExciteL6
CCCTCAAGTATTTCTC	MOLs
CCCTCTCAGATGCTGG	ExciteL6
CCCTCTCGTAACATAG	ExciteL4
CCCTCTCTCAGTCTTT	MOLs
CCCTCTCTCTGAGCAT	ExciteL23
CCCTGATAGGATACGC	ExciteL6
CCCTGATAGTGGACTG	Microglia
CCCTGATCAAGGTACG	ExciteL4
CCCTGATCAGCATACT	ExciteL4
CCCTGATGTCTGATCA	MOLs
CCCTGATTCCACCTCA	ExciteL5
CCCTTAGAGCAGCACA	ExciteL6
CCCTTAGAGCTTAAGA	MOLs
CCCTTAGAGTCATACC	ExciteL6
CCCTTAGCAGGCGTTC	ExciteL4
CCGAACGCACAGTGAG	Endo
CCGAACGGTATTTCCT	ExciteL6
CCGATCTCAACCAGAG	ExciteL6
CCGATCTCACTATGTG	ExciteL23
CCGATCTCAGGAATAT	ExciteL23
CCGATCTTCGAATGCT	ExciteL6
CCGATGGAGAAACTGT	Microglia
CCGATGGAGACTCTAC	Astrocytes
CCGATGGAGTCTTCCC	MOLs
CCGATGGTCTAGCCAA	MOLs
CCGCAAGGTACCATAC	ExciteL6
CCGCAAGGTCACTACA	Microglia
CCGCAAGTCAGTGCGC	ExciteNP
CCGCAAGTCCGACGGT	ExciteL4
CCGGACAAGAGAAGGT	MOLs
CCGGACAAGCCTATCA	Macrophages
CCGGACAGTACATACC	MOLs
CCGGACATCACCATAG	Macrophages
CCGGACATCCGCCTAT	MOLs
CCGGGTAAGCCATTGT	ExciteL4
CCGGGTACAGCTGCCA	OPCs
CCGGGTAGTCAATCTG	COPs
CCGGGTATCATTATCC	ExciteL6
CCGGTAGAGACATACA	ExciteL6
CCGGTAGAGCTGACAG	ExciteL23
CCGGTAGCACGGTAGA	NIPCs
CCGGTAGCAGCCTTCT	ExciteL4
CCGGTAGCATTGCTTT	MOLs
CCGGTGACAACACAAA	ExciteL6
CCGGTGACACTCGATA	ExciteL4
CCGGTGACAGACCGCT	ExciteL4
CCGGTGAGTCCGAAAG	Microglia
CCGGTGAGTTAAGAAC	ExciteL5
CCGTGAGCATCATCTT	ExciteL4
CCGTGAGGTCTCTCTG	ExciteL6
CCGTGAGTCCACGTCT	Astrocytes
CCGTGAGTCGGCGATC	ExciteL4
CCGTTCAGTCGTTTCC	ExciteL6
CCGTTCAGTGTTCGAT	ExciteL6
CCGTTCATCTCTATGT	ExciteL4
CCTAACCAGTATGATG	COPs
CCTAACCAGTATGGCG	ExciteL6
CCTAACCCATGACACT	ExciteL6
CCTAACCTCATCGCTC	MOLs
CCTACGTAGCGATGGT	ExciteL4
CCTACGTAGGTGTGAC	InhibNeuron
CCTACGTAGTATGGCG	ExciteL6
CCTACGTGTCTGTGGC	ExciteL4
CCTACGTTCGTTCTGC	ExciteL4
CCTATCGAGGAGGTTC	ExciteL6
CCTATCGCAATTCGTG	ExciteL4
CCTATCGCATTCATCT	ExciteL6
CCTCAACAGTTTCTTC	ExciteL6
CCTCAACCATAATCGC	ExciteL6
CCTCAACGTAGCGATG	ExciteL4
CCTCAACTCATAGGCT	COPs
CCTCAACTCTCTTAAC	MOLs
CCTCAACTCTTTGGAG	ExciteL4
CCTCACAAGACAGTCG	OPCs
CCTCACAAGTTTGCTG	InhibNeuron
CCTCACACAGTCGTTA	ExciteNP
CCTCACAGTCTTTATC	ExciteL5
CCTCACAGTTGAGTCT	COPs
CCTCAGTTCAATCAGC	ExciteL6
CCTCAGTTCGAGAACG	Pericytes
CCTCATGCAATCTGCA	ExciteL4
CCTCATGTCGCGGTAC	ExciteL4
CCTCCAACATGTGTCA	ExciteL6
CCTCCAAGTAATTAGG	ExciteL4
CCTCCAAGTTGGTGTT	ExciteL5
CCTCCAATCCAAAGGG	ExciteL6
CCTCCAATCGACCCAG	Astrocytes
CCTCCAATCTTTGATC	ExciteL6
CCTCCTCCACCCATAA	Astrocytes
CCTCCTCCATATGCGT	Microglia
CCTCCTCGTGGCTTGC	ExciteL6
CCTCCTCTCTTCTTCC	OPCs
CCTCTAGAGATGATTG	ExciteL6
CCTCTAGCATATCTGG	MOLs
CCTCTAGTCATCTGTT	ExciteL4
CCTCTAGTCGACCCAG	MOLs
CCTCTAGTCTAGTGTG	ExciteL6
CCTCTCCAGCATCGAG	ExciteL6
CCTCTCCCAAGAGTAT	ExciteL6
CCTCTCCCACTAGAGG	MOLs
CCTCTCCCACTCACTC	ExciteL4
CCTCTCCGTAGTGATA	ExciteL23
CCTCTCCGTCACGTGC	ExciteL6
CCTCTCCTCTGGGCAC	Microglia
CCTGCATAGTGACCTT	MOLs
CCTGCATCACTTGGGC	MOLs
CCTGCATGTCTCTCTG	Pericytes
CCTGCATTCGTTCTCG	OPCs
CCTGCATTCTTCCCAG	ExciteL4
CCTGCATTCTTTCCGG	MOLs
CCTGTTGGTCTACATG	ExciteL5
CCTGTTGTCAACTCTT	MOLs
CCTTCAGCAAGAGGCT	ExciteL4
CCTTCAGGTACCCACG	ExciteL6
CCTTGTGAGAGTAACT	ExciteL6
CCTTGTGAGTACGTCT	ExciteL4
CCTTGTGCACTTCAAG	ExciteL6
CCTTGTGCATCCGTGG	MOLs
CCTTGTGCATGACACT	ExciteL4
CCTTGTGGTGGGATTG	ExciteL4
CCTTGTGTCATCGCAA	OPCs
CCTTGTGTCGAGCCAC	ExciteL4
CCTTGTGTCTTCCAGC	MOLs
CCTTTGGGTCAACCTA	Microglia
CGAAGGACACATCCCT	ExciteL6
CGAAGTTGTAGTAAGT	MOLs
CGAAGTTTCAACTGAC	ExciteL6
CGAAGTTTCCTTATGT	ExciteL4
CGAATTGAGGCACTCC	ExciteL4
CGAATTGCACGCCAGT	InhibNeuron
CGAATTGGTGGCTGAA	ExciteL6
CGAATTGGTGTGACCC	Microglia
CGACAGCGTATTCCTT	ExciteL6
CGACAGCGTTCATCGA	ExciteL6
CGAGAAGAGTCAAGCG	InhibNeuron
CGAGAAGCAGATTAAG	MOLs
CGAGAAGGTCCGGCAT	ExciteL6
CGAGAAGTCGATACGT	ExciteL4
CGAGGAAAGCTTTCTT	ExciteL6
CGAGGAACACATCATG	OPCs
CGAGGAACACTCGATA	ExciteL4
CGAGGAACAGAGATGC	MOLs
CGAGGAAGTGCGCTCA	ExciteNP
CGAGGCTAGGCTCTCG	Pericytes
CGAGGCTCACTTGGCG	ExciteL4
CGAGTGCAGTCACGCC	MOLs
CGAGTGCTCTGCTAGA	MOLs
CGAGTTACAAGAGTTA	MOLs
CGAGTTACAGTAACGG	ExciteL6
CGAGTTATCAGATGCT	MOLs
CGAGTTATCCGTGTCT	Macrophages
CGAGTTATCTAGTCAG	Microglia
CGATCGGCATGACAAA	Microglia
CGATCGGGTGTTACAC	ExciteL4
CGATCGGTCTCCCATG	ExciteL6
CGATGCGCAATTGGTC	ExciteL6
CGATGCGTCATGGCCG	ExciteL4
CGATGCGTCGTTGCCT	ExciteL6
CGATGGCAGGGAGGGT	ExciteL6
CGATGGCCATCCAACA	MOLs
CGATGGCGTAGAGCTG	ExciteL4
CGATGGCTCACCATGA	MOLs
CGATGGCTCCTTTAGT	ExciteL6
CGCAGGTAGCTAAGTA	InhibNeuron
CGCAGGTAGCTCGACC	ExciteL4
CGCAGGTGTCTACTGA	ExciteL5
CGCAGGTGTCTATGAC	ExciteL5
CGCAGGTGTTCCCACT	Astrocytes
CGCATAAGTATGGTAA	Macrophages
CGCATAAGTATTGGCT	ExciteL5
CGCATAATCGTCGGGT	ExciteL4
CGCATGGCACAGTCCG	ExciteL4
CGCATGGCAGACAATA	ExciteL4
CGCATGGGTACTAGCT	MOLs
CGCCAGACACTAACGT	ExciteL5
CGCCAGAGTAGACAGC	ExciteL23
CGCCAGAGTTAGGGAC	Microglia
CGCCAGATCTCCGATC	MOLs
CGCCATTCAAGATTGA	ExciteL6
CGCCATTGTCGTTATG	Pericytes
CGCCATTTCAACTGGT	ExciteL5
CGCCATTTCGACGCTG	InhibNeuron
CGCGTGAGTCGCCTAG	InhibNeuron
CGCGTGAGTGAACGGT	ExciteNP
CGCGTGATCGCCACTT	Astrocytes
CGGAACCAGAGCAGCT	ExciteL6
CGGAACCAGCAGATAT	ExciteL4
CGGAACCAGGGTGAGG	ExciteL6
CGGAACCAGGTGCGAT	ExciteNP
CGGAACCCAACTTGCA	COPs
CGGAACCGTGACAGGT	OPCs
CGGAACCGTGCAGGAT	Microglia
CGGAATTCAACGATTC	ExciteL6
CGGAATTCAGGGCTTC	ExciteL6
CGGAATTGTGGGTATG	ExciteL4
CGGAATTTCTAAGGAA	Microglia
CGGACACCAATGTGGG	ExciteL4
CGGACACGTCTCAGAT	OPCs
CGGAGAAAGCGTATAA	Microglia
CGGAGAACAGACCTAT	ExciteL6
CGGAGAAGTCAAAGTA	ExciteNP
CGGCAGTAGGTAAAGG	NIPCs
CGGGACTAGAGTGTGC	ExciteL6
CGGGACTAGTTAACGA	MOLs
CGGGACTCAACTGAAA	Astrocytes
CGGGACTCACATGGTT	Astrocytes
CGGGACTCATAAGCGG	Astrocytes
CGGGACTGTCGTAATC	ExciteL6
CGGGACTGTGGCAACA	MOLs
CGGGCATCAACACGTT	ExciteL4
CGGGCATGTCGAAGCA	Microglia
CGGGTCAAGATGGTAT	MOLs
CGGGTCAAGCGTGTTT	Microglia
CGGGTCACATTAAAGG	ExciteL6
CGGGTGTAGAGCAGAA	ExciteL4
CGGGTGTCAAGCCATT	ExciteL6
CGGGTGTGTGAGCCAA	ExciteL5
CGTAAGTCAGGTTACT	ExciteL4
CGTAAGTGTCAACGCC	MOLs
CGTAAGTGTCGAAACG	ExciteL4
CGTAAGTGTGGCTAGA	ExciteL6
CGTAAGTTCCTACCGT	OPCs
CGTAAGTTCCTCACTG	MOLs
CGTAATGCATTCAGCA	MOLs
CGTAATGGTTCCTAGA	Astrocytes
CGTAGTAAGTGAGCCA	InhibNeuron
CGTAGTAGTATCAGGG	MOLs
CGTAGTAGTTTAAGGA	MOLs
CGTAGTATCTCAACGA	ExciteL23
CGTCAAAGTAGCGCCT	ExciteL4
CGTCAAAGTCTGCGCA	Pericytes
CGTCAAATCTATACGG	MOLs
CGTCCATAGCAGTCTT	ExciteL6
CGTCCATCAGGTCTCG	Microglia
CGTCCATGTCCAAAGG	OPCs
CGTCCATTCGAGTGGA	MFOLs
CGTGAATAGGTGCATG	Microglia
CGTGAATAGTGTGTTC	OPCs
CGTGAATCAATCGCGC	MOLs
CGTGAATGTATGGGAC	MOLs
CGTGAATGTGACCTGC	Microglia
CGTGAATGTTTACCTT	Macrophages
CGTGAATTCAGGTGTT	MOLs
CGTGAATTCCTTTAGT	ExciteL6
CGTGAATTCTATCGCC	ExciteL4
CGTGATACAATACCTG	ExciteL6
CGTGATAGTGCGTGCT	Microglia
CGTGCTTAGCTCCCTT	ExciteL6
CGTGCTTCAAGTGTCT	MOLs
CGTGTCTAGCGCAATG	ExciteL5
CGTGTCTCAAGCACCC	ExciteL6
CGTGTCTCACCGTACG	ExciteL6
CGTGTCTCACGTCATA	ExciteL6
CGTGTCTCAGGCACAA	Astrocytes
CGTGTCTGTCGGCCTA	Pericytes
CGTTAGAAGACAGTCG	Astrocytes
CGTTAGAGTGGAAGTC	ExciteL4
CGTTCTGAGCATCCCG	MOLs
CGTTCTGAGGTCCCGT	ExciteNP
CGTTCTGCAACTCATG	ExciteL4
CGTTCTGCACTACGGC	ExciteL6
CGTTCTGGTCTTGCTC	MOLs
CGTTCTGTCATCTCTA	ExciteL4
CGTTCTGTCCGACATA	MOLs
CGTTGGGAGACTGAGC	ExciteL4
CGTTGGGAGATAGCTA	MOLs
CGTTGGGCATACAGGG	InhibNeuron
CGTTGGGTCATCGCTC	OPCs
CGTTGGGTCTATCGTT	ExciteL6
CTAACCCCAGGGAATC	Astrocytes
CTAACCCGTAGAGCTG	ExciteL4
CTAACTTAGAGTCGAC	Pericytes
CTAACTTCAGACTCTA	ExciteL4
CTAACTTCAGAGGACT	InhibNeuron
CTAACTTGTACAGTTC	ExciteL4
CTAACTTGTTAATCGC	ExciteL6
CTAACTTTCGGTCTAA	MOLs
CTAACTTTCTTCCCAG	MOLs
CTAAGTGAGAGTCTTC	Astrocytes
CTAAGTGAGTGGACTG	OPCs
CTAAGTGGTCAGGCAA	Microglia
CTAAGTGGTGTCTTAG	ExciteL6
CTAAGTGTCGCCGTGA	ExciteL23
CTACAGACAAATTGCC	Astrocytes
CTACAGAGTTGGGATG	ExciteL23
CTACATTAGACCAGAC	ExciteL6
CTACATTAGGAAAGGT	OPCs
CTACATTCAGGTTCGC	OPCs
CTACCCAAGTATGAAC	MOLs
CTACCCACAGCTGCCA	MOLs
CTACCCAGTTACCTGA	ExciteL6
CTACCTGAGGCACTCC	ExciteL6
CTACCTGAGGTCCAGA	ExciteL4
CTACCTGAGTGTACCT	ExciteL6
CTACCTGAGTTCCATG	OPCs
CTACCTGCAAGACTGG	MOLs
CTACCTGCAGATTAAG	InhibNeuron
CTACCTGCAGGATGAC	Macrophages
CTACCTGGTCGCGTCA	ExciteL6
CTACCTGTCCCTCAAC	ExciteL4
CTACCTGTCTCCCAAC	MOLs
CTACCTGTCTCTCTTC	ExciteL6
CTACCTGTCTGCTGAA	OPCs
CTACGGGAGCCTCTTC	ExciteL4
CTACGGGAGGTATAGT	ExciteL6
CTACGGGGTATACCCA	MOLs
CTACGGGGTCACGTGC	MOLs
CTACGGGGTGAAAGTT	OPCs
CTACGGGTCACCCTGT	Astrocytes
CTACGGGTCCAATCCC	Microglia
CTACTATAGCAATAGT	ExciteL4
CTACTATCACCAGGTC	Microglia
CTACTATCAGGAATAT	ExciteL23
CTACTATCATGCAGGA	OPCs
CTACTATCATTGCCTC	ExciteL5
CTACTATTCGGCGATC	ExciteL4
CTAGACAAGCACTAGG	Macrophages
CTAGACAGTAATGTGA	InhibNeuron
CTAGACAGTGGCTGCT	MOLs
CTAGACATCGTCGACG	Microglia
CTAGGTAAGCAGGTCA	ExciteL4
CTAGGTAAGCCTCAGC	Microglia
CTAGGTAAGGTAGCAC	ExciteNP
CTAGGTACAAAGACGC	MOLs
CTAGGTATCAAAGGTA	ExciteL23
CTATAGGAGAGGTATT	ExciteL6
CTATAGGAGCCGATAG	MFOLs
CTATAGGAGGGCTAAC	ExciteL4
CTATAGGCAATTCTTC	MFOLs
CTATAGGCATGAGAAT	InhibNeuron
CTATAGGTCTACCACC	ExciteL4
CTATCTACAGCTATAC	InhibNeuron
CTATCTACATTAAAGG	ExciteL4
CTATCTAGTCCTCCAT	MOLs
CTATCTATCAGGACAG	ExciteL4
CTCAACCCATCACCAA	ExciteL4
CTCAACCGTCGCACGT	MOLs
CTCAACCTCCACGAAT	ExciteL6
CTCAACCTCCAGCTCT	ExciteL4
CTCAAGACACACACGC	ExciteNP
CTCAAGAGTGTAAATG	MOLs
CTCAATTAGCGTGTCC	ExciteL4
CTCAATTAGGTATTGA	MFOLs
CTCAATTAGTCAACAA	ExciteL4
CTCAATTAGTTCTACG	MOLs
CTCAATTGTAGTGCGA	ExciteL4
CTCAATTGTTGTGTAC	NIPCs
CTCAATTTCGGATAAA	ExciteL6
CTCAATTTCTCAGTCC	InhibNeuron
CTCACTGAGAAGCTGC	ExciteL5
CTCACTGCAAGTAGTA	MOLs
CTCACTGCAAGTTCGT	OPCs
CTCACTGCAGTATTCG	ExciteL6
CTCACTGCATAGATGA	ExciteL6
CTCACTGGTATATGGA	ExciteL6
CTCACTGGTCTGCATA	MOLs
CTCACTGTCCGTATGA	MOLs
CTCAGAAAGATCCTAC	Microglia
CTCAGAAAGTCGTTAC	ExciteL5
CTCAGAACAACAGCCC	ExciteL6
CTCAGAACAGCCCACA	ExciteL4
CTCAGAAGTATTGCCA	ExciteNP
CTCAGAAGTGGTCCCA	ExciteL4
CTCAGAAGTGTGATGG	Pericytes
CTCAGAAGTTAAACCC	ExciteL6
CTCAGAATCGTCTCAC	Astrocytes
CTCAGGGAGGTTAGTA	ExciteL6
CTCAGGGCACGCTGCA	ExciteNP
CTCAGGGGTTGTGCAT	MOLs
CTCAGTCAGGAGCAAA	Microglia
CTCAGTCAGGTCGAGT	Astrocytes
CTCAGTCCAAACAGGC	COPs
CTCAGTCGTTCCGCGA	Microglia
CTCAGTCGTTCTCTAT	Microglia
CTCATCGAGGGTTGCA	MOLs
CTCATCGCACCGAATT	ExciteL4
CTCATCGGTGCTCCGA	Astrocytes
CTCATCGGTGTTGACT	MOLs
CTCATCGTCAGAGCGA	ExciteL6
CTCATGCAGCGAATGC	ExciteL6
CTCATGCGTGTGTGTT	ExciteNP
CTCATGCTCCCTCATG	OPCs
CTCATGCTCCTATTGT	InhibNeuron
CTCATTAAGACAGTCG	Microglia
CTCATTACATCATCCC	InhibNeuron
CTCATTAGTCACGACC	ExciteL4
CTCATTAGTCTTCGAA	Astrocytes
CTCATTATCGGAGATG	ExciteL6
CTCCAACAGGGCTTCC	ExciteL6
CTCCAACAGTAGTCAA	ExciteL6
CTCCAACCATCTTTCA	MOLs
CTCCAACTCCTTCGAC	Astrocytes
CTCCAACTCGGATTAC	ExciteL6
CTCCACAAGGCTCTCG	OPCs
CTCCACAGTAACTGCT	MOLs
CTCCACAGTAGATCCT	MOLs
CTCCACATCTGGGCAC	ExciteL6
CTCCATGCACCTGATA	OPCs
CTCCATGGTAGTATAG	Microglia
CTCCATGGTTATTCCT	Pericytes
CTCCCAACAACATCGT	ExciteL4
CTCCCAATCATTGTTC	ExciteL4
CTCCCAATCGAACACT	MOLs
CTCCCAATCGTGGTAT	MOLs
CTCCCAATCTTAGGAC	Microglia
CTCCCTCGTCTCGCGA	ExciteL6
CTCCGATCAGTAGTGG	ExciteL4
CTCCGATCATCATTTC	ExciteL5
CTCCGATGTACCAATC	ExciteNP
CTCCGATGTCATCCGG	Astrocytes
CTCCGATGTCTTGCGG	Microglia
CTCCGATTCACAAGAA	InhibNeuron
CTCCGATTCCATAGGT	Pericytes
CTCCGATTCCGTAATG	ExciteL23
CTCCGATTCTAGCCAA	Astrocytes
CTCCGATTCTATCGTT	OPCs
CTCCGATTCTGAATGC	Astrocytes
CTCCTCCAGGACTGGT	ExciteL4
CTCCTCCAGGGAGGCA	ExciteL4
CTCCTCCAGGGTACAC	ExciteL6
CTCCTCCCAGACATCT	ExciteL6
CTCCTCCCAGCACAAG	ExciteL6
CTCCTCCGTTCAAACC	InhibNeuron
CTCCTTTAGAGTGAAG	MOLs
CTCCTTTCACGGGTAA	MOLs
CTCCTTTCAGGATGAC	Pericytes
CTCCTTTGTCAAACGG	MOLs
CTCGAGGAGGATTTGA	ExciteL6
CTCGAGGAGGCTATCT	Astrocytes
CTCGAGGCAAAGGCTG	ExciteL5
CTCGAGGGTGGCAACA	OPCs
CTCTCAGAGACATCAA	ExciteL5
CTCTCAGCAGGCTCTG	MOLs
CTCTCAGGTAAGCTCT	ExciteL6
CTCTCAGGTAAGGCTG	Microglia
CTCTCAGTCCGAGTGC	ExciteL6
CTCTCGACAGTCAGTT	ExciteNP
CTCTCGAGTCGACTGC	MOLs
CTCTCGATCATAAGGA	ExciteL23
CTCTCGATCTGCTGAA	ExciteL6
CTGAATGAGCATCTTG	ExciteL6
CTGAATGAGTTCGCAT	ExciteNP
CTGAATGCATTAGGAA	ExciteL5
CTGAATGGTAACGGTG	InhibNeuron
CTGAATGGTCTCGGAC	ExciteNP
CTGAATGTCAATCCGA	Microglia
CTGAGCGCAGTAACGG	ExciteL4
CTGAGCGCAGTCGCTG	ExciteL5
CTGAGCGGTATCGTAC	ExciteL4
CTGAGCGTCCAATGCA	ExciteL4
CTGAGGCCATTACTCT	Macrophages
CTGAGGCTCTCTTCAA	MOLs
CTGATCCCACAAATGA	MOLs
CTGATCCCAGTGGCTC	Microglia
CTGATCCGTCCGGTGT	Microglia
CTGATCCTCTGGGATT	Endo
CTGCAGGGTAGGTGCA	ExciteL6
CTGCAGGGTCCGGTGT	ExciteNP
CTGCAGGTCGAGATGG	ExciteL4
CTGCATCCACTCATAG	ExciteL4
CTGCATCGTGAACTAA	Microglia
CTGCCATAGCCAGACA	ExciteL4
CTGCCATCATGCCGGT	ExciteL4
CTGCCATTCGAGATAA	ExciteL4
CTGCCATTCGATCCAA	Pericytes
CTGCCATTCGTAGGAG	ExciteL4
CTGCCTAAGATCGGTG	ExciteL6
CTGCCTACACAGCATT	ExciteL6
CTGCCTACAGGCGTTC	ExciteL6
CTGCCTAGTCCAAATC	MOLs
CTGCCTAGTCCGAAGA	MOLs
CTGCCTAGTCGTGCCA	MOLs
CTGCCTATCTCATGGA	ExciteL4
CTGCGAGAGATCGCTT	InhibNeuron
CTGCGAGAGGCCGCTT	MOLs
CTGCGAGTCCGTCAAA	ExciteL6
CTGCTCAAGGGCCCTT	InhibNeuron
CTGCTCAAGTAAATGC	ExciteL6
CTGCTCACATGCCATA	MOLs
CTGCTCATCGCTACGG	InhibNeuron
CTGGACGAGTAACGAT	ExciteL4
CTGGACGCAATCCTTT	Astrocytes
CTGGACGGTGTCTAAC	ExciteL4
CTGGACGTCCTTATAC	COPs
CTGGCAGAGCATCTTG	ExciteL4
CTGGCAGAGTCTGCAT	ExciteL6
CTGGCAGGTCACTCGG	ExciteL6
CTGGCAGTCATCTACT	ExciteL6
CTGGCAGTCCTCTAAT	MOLs
CTGGCAGTCGCTAGCG	ExciteL6
CTGGCAGTCTGCGGAC	Astrocytes
CTGGTCTCACAAATGA	Microglia
CTGGTCTCACTGCGAC	Astrocytes
CTGGTCTGTAACCCTA	ExciteNP
CTGGTCTGTAGCGATG	ExciteNP
CTGGTCTGTGGCTAGA	ExciteL6
CTGTACCAGGGTTAAT	MOLs
CTGTACCCATCGATAC	MOLs
CTGTACCGTCTGCCTT	ExciteL4
CTGTAGAAGCACTCTA	ExciteL6
CTGTAGAAGGTGCATG	MOLs
CTGTAGACATAGAATG	ExciteL4
CTGTAGAGTCTAACTG	Microglia
CTGTAGAGTGTATCCA	ExciteL5
CTGTAGAGTGTGTCGC	Astrocytes
CTGTAGATCCAATCTT	Microglia
CTGTATTAGAGGGTAA	Microglia
CTGTATTAGTTCTCTT	ExciteL6
CTGTATTCACTTGGCG	InhibNeuron
CTGTATTGTAGACTGG	ExciteL4
CTGTATTGTCCTTTGC	ExciteL4
CTGTATTTCAGTCACA	ExciteL6
CTGTCGTAGCATCGAG	InhibNeuron
CTGTCGTCAAAGGCTG	InhibNeuron
CTGTCGTCACAAGGTG	OPCs
CTGTCGTGTTCATCTT	ExciteL4
CTGTGAATCAACGAGG	Pericytes
CTGTGGGAGAGTTGAT	MOLs
CTGTGGGAGGCCTAGA	ExciteL6
CTGTGGGAGGGTACGT	ExciteL4
CTGTGGGAGTCAGCCC	MOLs
CTGTGGGCAAGTGCAG	Microglia
CTGTGGGGTCGCAGTC	ExciteL4
CTGTGGGGTGGACCTC	ExciteL4
CTTACCGAGCATCGAG	ExciteL4
CTTACCGTCATACGGT	ExciteL6
CTTAGGAAGAGATTCA	ExciteL23
CTTAGGATCCACTTCG	ExciteL4
CTTCAATGTCGACTTA	ExciteL6
CTTCAATGTGTCTCCT	ExciteL4
CTTCAATGTTTAGTCG	ExciteL4
CTTCAATTCGCCTCTA	MOLs
CTTCCGAAGTGGCGAT	Microglia
CTTCCGAAGTTACGTC	ExciteL4
CTTCCGATCGTTACCC	ExciteL6
CTTCCTTAGTACCGGA	MOLs
CTTCCTTCAGTCGCTG	ExciteL4
CTTCCTTGTACCTATG	ExciteL6
CTTCCTTTCCATTTAC	Astrocytes
CTTCGGTAGCCTAACT	ExciteL6
CTTCGGTAGGATGTTA	Microglia
CTTCGGTAGGCAGCTA	InhibNeuron
CTTCGGTGTATGAGCG	Astrocytes
CTTCTAAAGAATCCCT	ExciteL4
CTTCTAAAGCAACTTC	ExciteL6
CTTCTAAGTATGAGAT	ExciteL6
CTTCTAATCCGTATAG	ExciteL6
CTTCTAATCGGAAACG	ExciteL4
CTTCTCTAGTTTAGGA	OPCs
CTTCTCTCAGCTTCCT	ExciteNP
CTTCTCTGTTACGTAC	ExciteL6
CTTCTCTGTTTGGGTT	ExciteL4
CTTCTCTTCCCGTGTT	MOLs
CTTGAGAAGACTTGTC	Microglia
CTTGAGATCATTTGTC	Astrocytes
CTTGAGATCGATACTG	ExciteL4
CTTGATTCAGACCAGA	ExciteL6
CTTGATTGTACGTAGG	ExciteL4
CTTGATTGTGCCGTAC	ExciteL6
CTTTCAAAGTACGAGC	ExciteL4
CTTTCAACACGGCCAT	ExciteL6
CTTTCAATCATCGACA	ExciteL5
CTTTCAATCGACATAC	OPCs
CTTTCGGAGTGCCGAA	MOLs
CTTTCGGCAGAACTCT	ExciteL5
CTTTCGGTCAAGTCGT	MOLs
GAAACCTTCCCAGGCA	MOLs
GAAATGAGTATGAAAC	MOLs
GAAATGAGTCGACTTA	ExciteL4
GAAATGATCGGCTGTG	ExciteNP
GAACACTAGCACACAG	Astrocytes
GAACACTCAGCTACTA	MOLs
GAACGTTAGTAACAGT	Microglia
GAACGTTAGTAACCTC	MOLs
GAACGTTCAAGAGATT	ExciteNP
GAACGTTCATAATGAG	ExciteL4
GAACGTTGTTGCTCAA	Astrocytes
GAACGTTTCAGGAGAC	InhibNeuron
GAACTGTAGAGATCGC	ExciteL6
GAACTGTTCGGAGTGA	OPCs
GAAGAATAGGGTTAGC	ExciteL4
GAAGAATAGTGACACG	ExciteL6
GAAGAATGTGGTCTTA	ExciteL5
GAAGCCCAGCGCTTCG	ExciteL4
GAAGCCCGTGATACAA	Endo
GAAGCCCGTGTTCCAA	OPCs
GAAGCCCTCCACTGAA	COPs
GAAGCCCTCTAGCAAC	InhibNeuron
GAAGCGAGTATGTCTG	ExciteL6
GAAGCGATCGGATAAA	MOLs
GAAGGACTCCGATGCG	MOLs
GAAGGACTCGGATACT	ExciteL4
GAAGGGTGTATCCTTT	Pericytes
GAAGGGTTCGCCTTGT	InhibNeuron
GAAGTAAAGCGCACAA	MOLs
GAAGTAAAGGTCGACA	Pericytes
GAAGTAACAGCAGAAC	MOLs
GAAGTAAGTCCCACGA	ExciteL4
GAATAGAAGACGTCCC	ExciteL4
GAATAGAAGCTAATGA	Microglia
GAATAGAAGTCACGAG	ExciteL6
GAATAGACACTAGGTT	ExciteL6
GAATAGACATTGGATC	MOLs
GAATAGAGTATCACCA	OPCs
GAATAGATCAAGAGGC	ExciteL4
GAATCACAGAGGTTTA	ExciteL6
GAATCACCAAAGGGCT	ExciteL6
GAATCACCACACAGAG	ExciteL4
GAATCACGTCCTACAA	ExciteL6
GAATCACGTGAGTTGG	MOLs
GAATCGTCAAGCCCAC	MOLs
GAATCGTTCTTCGCTG	ExciteL6
GACACGCAGGAGATAG	ExciteNP
GACACGCGTGGTCAAG	InhibNeuron
GACACGCTCTTTCAGT	NIPCs
GACAGCCGTATTCTCT	ExciteNP
GACAGCCGTGGTTTAC	Microglia
GACAGCCTCCGCAAAT	ExciteL4
GACCAATAGAAGCTGC	ExciteL4
GACCAATAGACGACTG	ExciteL6
GACCAATAGGTGCTGA	ExciteL4
GACCAATAGTTGTACC	ExciteL4
GACCAATCACCTTCGT	OPCs
GACCAATCAGGGACTA	ExciteL4
GACCAATGTAGGTACG	ExciteL4
GACCAATGTGCTTCAA	ExciteL6
GACCAATGTTCTCGTC	MOLs
GACCAATGTTTGTTCT	ExciteL4
GACCCAGCACCCTTGT	Astrocytes
GACCCTTAGGAAGTGA	ExciteL5
GACCCTTAGGGCAACT	MOLs
GACCCTTGTGACCGAA	Microglia
GACCCTTTCGGCTTCT	MOLs
GACCCTTTCTGGCCAG	ExciteL6
GACCGTGAGGAACTAT	InhibNeuron
GACCGTGAGGAGAGGC	ExciteL4
GACCGTGCAATAGAGT	MOLs
GACCGTGCACTCACTC	Microglia
GACCGTGGTGATAGAT	Astrocytes
GACCGTGTCGTCAGAT	ExciteL4
GACCTTCAGAGTATAC	MOLs
GACCTTCAGATAACGT	ExciteL4
GACCTTCCACTGAATC	ExciteL4
GACCTTCCATCGTGGC	ExciteL6
GACCTTCGTGCGTTTA	ExciteL23
GACCTTCTCCTCCACA	ExciteL6
GACGCTGGTATGGGAC	MOLs
GACGCTGTCGAAACAA	Macrophages
GACGCTGTCTGCGTCT	MOLs
GACGTTATCAGTGTCA	ExciteL4
GACTATGAGCACTCAT	MOLs
GACTATGAGGGAGTTC	Microglia
GACTATGAGGGCCCTT	ExciteL4
GACTATGCAAAGGTTA	Macrophages
GACTATGGTATTTCTC	ExciteL4
GACTATGGTGCCGAAA	ExciteL6
GACTATGTCCCAAGCG	ExciteL6
GACTCAAAGGAGAATG	MOLs
GACTCAAGTATACAGA	MOLs
GACTCAAGTCTAGGTT	Astrocytes
GACTCTCAGAGCACTG	Microglia
GACTCTCCAGAGCTAG	MOLs
GACTCTCGTTGCTCGG	InhibNeuron
GACTCTCTCCGCACGA	ExciteL6
GACTGATAGGCGTCCT	Microglia
GACTGATAGGGCAAGG	MOLs
GACTGATTCTCCAAGA	ExciteL4
GACTTCCGTATGAGGC	ExciteL6
GAGAAATAGCAAGTGC	ExciteL4
GAGAAATAGGCACGAT	ExciteNP
GAGAAATAGGTATCTC	MOLs
GAGAAATCAGGCTACC	ExciteL5
GAGACCCAGTTGGCGA	ExciteL6
GAGACCCCAATGCTCA	ExciteL4
GAGACCCCAGTACTAC	ExciteL6
GAGACTTGTGGGATTG	MOLs
GAGACTTGTTGTGTTG	ExciteL4
GAGAGGTAGACATCAA	InhibNeuron
GAGAGGTAGCTGTACT	MOLs
GAGAGGTAGTCAACAA	InhibNeuron
GAGAGGTCAGCAGAAC	InhibNeuron
GAGAGGTCAGGCAATG	ExciteL4
GAGAGGTCATACACCA	ExciteL6
GAGAGGTTCGGCTATA	InhibNeuron
GAGATGGAGTTGGCTT	ExciteL6
GAGATGGCAGTATTCG	InhibNeuron
GAGATGGCATCCTTCG	MOLs
GAGATGGGTACGCTTA	ExciteL4
GAGATGGGTGGAAGTC	ExciteL6
GAGCCTGAGAAACCAT	OPCs
GAGCCTGCAACCTAAC	MFOLs
GAGCCTGGTAGACAAT	OPCs
GAGCCTGGTGTGTCGC	OPCs
GAGCCTGTCTCGGTCT	ExciteL4
GAGCTGCAGCCTGACC	ExciteL4
GAGCTGCCAGTGAGCA	ExciteL4
GAGCTGCGTAGCCAGA	ExciteL4
GAGCTGCGTGGCGCTT	ExciteL4
GAGGCAATCAACGCTA	MOLs
GAGGCAATCTTTGATC	ExciteL6
GAGGCCTAGGTGAGAA	ExciteL4
GAGGCCTGTGCATTAC	ExciteL5
GAGGCCTTCTTAGCTT	ExciteL6
GAGGGATAGAAGCTGC	ExciteL4
GAGGGATCAAATAGCA	ExciteL5
GAGGGATGTGTTCGAT	ExciteL6
GAGGGTACACACGTGC	OPCs
GAGGGTACAGAGTTCT	MOLs
GAGGGTAGTACGCTTA	ExciteL5
GAGGGTATCGACGCGT	ExciteL4
GAGGGTATCGCGTTTC	MOLs
GAGTCTAAGACTCTAC	Pericytes
GAGTCTAAGAGCCATG	ExciteL6
GAGTCTACACACACGC	ExciteL6
GAGTCTAGTAGAGACC	ExciteL23
GAGTCTATCACCTTAT	ExciteL4
GAGTGAGAGGCAATGC	ExciteL6
GAGTGAGCAATTTCTC	ExciteL4
GAGTGAGCACCCAAGC	InhibNeuron
GAGTGAGCACGCTGCA	NIPCs
GAGTGAGTCTAAGAAG	MOLs
GAGTGAGTCTACGGGC	ExciteL6
GAGTGTTAGACATACA	OPCs
GAGTGTTAGTTCCGTA	ExciteL6
GAGTGTTCAGCGATTT	ExciteL6
GAGTGTTGTAATTAGG	ExciteL4
GAGTGTTGTCACCGCA	ExciteL6
GAGTGTTGTGCGACAA	ExciteL5
GAGTGTTTCAAACCCA	OPCs
GAGTGTTTCCCATTCG	ExciteL6
GAGTGTTTCTAGTTCT	ExciteL6
GAGTTACCAATAGTCC	ExciteL6
GAGTTACGTAGCGTTT	Endo
GAGTTACGTGCGAGTA	Microglia
GAGTTACGTGGACAGT	ExciteL4
GAGTTACTCCGCACGA	ExciteL5
GAGTTGTAGTTCCATG	ExciteL4
GAGTTTGAGATCACTC	ExciteL4
GAGTTTGCAATCACGT	ExciteL6
GAGTTTGCATGTTTGG	Astrocytes
GAGTTTGGTATGCGGA	MOLs
GATAGAAAGCGGGTAT	ExciteL23
GATAGAACAGCCCACA	ExciteL6
GATAGAATCCTCTAGC	Microglia
GATAGCTAGAGTCCGA	ExciteL6
GATAGCTAGCCTGAAG	ExciteL4
GATAGCTCACGGTGTC	ExciteL6
GATAGCTGTTCCAAAC	InhibNeuron
GATCACACAAACCATC	MOLs
GATCACAGTGAGCTCC	ExciteL4
GATCAGTCAGTCAGCC	ExciteL4
GATCAGTGTGCTCTCT	MOLs
GATCAGTGTTAGGACG	MOLs
GATCAGTTCGACATTG	Astrocytes
GATCATGAGACTCCGC	ExciteL4
GATCATGAGGGAGGGT	OPCs
GATCATGCACCAGTAT	ExciteL4
GATCATGTCGAACGGA	ExciteL4
GATCATGTCTCATGGA	InhibNeuron
GATCCCTCAATGGCCC	Pericytes
GATCCCTCACAATTCG	Microglia
GATCCCTTCATAAGGA	MOLs
GATCCCTTCCCTTTGG	ExciteL4
GATCCCTTCGGCCTTT	ExciteNP
GATCCCTTCGTTGTGA	ExciteL5
GATCGTAAGAGTCACG	ExciteL6
GATCGTAAGCAAATCA	MFOLs
GATCGTACACAAAGCG	OPCs
GATCGTAGTATAGGGC	MOLs
GATCGTATCGGCCTTT	ExciteL4
GATGACTAGAGTGGCT	ExciteL6
GATGACTCATAATCCG	Microglia
GATGACTGTCTAGATC	OPCs
GATGAGGAGGGATCGT	MOLs
GATGAGGCAGAAACCG	ExciteL23
GATGAGGCAGGACGAT	OPCs
GATGAGGCATCGAAGG	ExciteL4
GATGAGGTCTGGGTCG	Microglia
GATGATCGTGTTACAC	Microglia
GATGCTACAGGATCTT	ExciteL6
GATGCTACATTGCCGG	OPCs
GATGCTATCATGAGTC	ExciteL4
GATGGAGAGCCTTGAT	MOLs
GATGGAGGTCGCATCG	ExciteL4
GATGTTGAGCTATCCA	MOLs
GATGTTGAGCTCGGCT	ExciteL6
GATGTTGCAAAGGCGT	ExciteL4
GATGTTGCAAGTGCTT	MOLs
GATGTTGCACCGTACG	ExciteL6
GATGTTGCAGACAAGC	ExciteNP
GATGTTGGTCCTGGTG	Microglia
GATGTTGGTCTCCTGT	Microglia
GATGTTGGTTGCTGAT	ExciteL6
GATGTTGGTTGGTGTT	ExciteL4
GATTCGAAGCGGTAGT	InhibNeuron
GATTCGAAGCTGGCTC	MOLs
GATTCGATCATTTCCA	ExciteL23
GATTCGATCCCGAACG	ExciteL4
GATTCTTAGACTCATC	ExciteL4
GATTCTTCAAAGGGTC	ExciteL6
GATTCTTCACTACTTT	OPCs
GATTCTTGTAGATCGG	OPCs
GATTCTTGTAGGTTTC	ExciteL4
GATTCTTTCGCTAATG	ExciteL4
GATTCTTTCGGAGTAG	InhibNeuron
GATTGGTAGTAGGATT	ExciteL6
GATTGGTAGTATTGCC	ExciteL6
GATTGGTCATAACCCA	ExciteL6
GATTTCTAGAGTCACG	Astrocytes
GATTTCTCACAACGTT	ExciteL6
GATTTCTCAGGCACAA	MOLs
GATTTCTCAGGTCCGT	MOLs
GATTTCTGTAGTCTTG	ExciteL6
GATTTCTGTGAGCGAT	MOLs
GATTTCTTCTCTGCCA	ExciteL6
GCAACATGTATGAGAT	ExciteNP
GCAACATGTGGCTTGC	Microglia
GCAACATTCCCTCTTT	ExciteL4
GCAACATTCGCTAAAC	ExciteL23
GCAACATTCGGATACT	NIPCs
GCAACCGGTCTTTCTA	ExciteL6
GCACATAAGCACCAGA	ExciteL6
GCACATACAGCAGTTT	ExciteL4
GCACATAGTCATTCCC	ExciteNP
GCACATATCGGCCTTT	Microglia
GCACATATCGTCTAAG	InhibNeuron
GCACGGTAGATGCAGC	ExciteL6
GCACGGTCATAGATCC	OPCs
GCACGGTGTAAGCTCT	ExciteL4
GCACGGTGTTATCTTC	ExciteL6
GCACGTGGTGACAGGT	ExciteL4
GCACGTGTCAGATGCT	Microglia
GCACGTGTCCATCTCG	Microglia
GCACGTGTCTACACTT	ExciteL6
GCACTAACAAGAGTTA	ExciteL6
GCACTAAGTGTGATGG	Microglia
GCAGCCAGTGAGTAAT	ExciteL4
GCAGCCAGTGGCCCAT	MOLs
GCAGCCAGTGTCCTAA	MOLs
GCAGCCATCGTCTAAG	ExciteL5
GCAGCTGCATCGATGT	ExciteL6
GCAGCTGGTAGCGCTC	ExciteL4
GCAGCTGTCCTCACTG	ExciteL4
GCAGGCTGTCACAATC	ExciteL6
GCAGGCTGTGCTCGTG	Astrocytes
GCAGGCTGTTAAACAG	ExciteL4
GCAGTTAGTGACCGAA	ExciteL23
GCAGTTATCAACGCTA	Astrocytes
GCATCGGCACTAAACC	Microglia
GCATCGGCAGCCTATA	ExciteL6
GCATCTCAGCCGGATA	ExciteL4
GCATCTCAGCCTCGTG	ExciteL5
GCATCTCAGGTCCTGC	ExciteNP
GCATCTCAGTCGGGAT	ExciteL6
GCATCTCCAGACCGCT	MOLs
GCATCTCGTATTTCTC	ExciteL4
GCATCTCTCCGTTTCG	ExciteL4
GCATGATAGCTAGAAT	ExciteL6
GCATGATCAAATGCTC	Pericytes
GCATGATGTCTTTCAT	Astrocytes
GCATGATTCCGGCTTT	OPCs
GCATTAGCATCAGCAT	ExciteL5
GCATTAGGTACAGCGA	ExciteL4
GCCAACGAGCTGAAAT	MOLs
GCCAACGCACGTCATA	Pericytes
GCCAACGGTCGCAACC	Pericytes
GCCAACGGTGTGAATA	MOLs
GCCAACGTCAAGCCCG	ExciteL6
GCCAACGTCGTAGTGT	ExciteL5
GCCAACGTCTCCGCAT	MOLs
GCCAGCAAGCCAAGGT	ExciteL5
GCCAGCAAGCGATGGT	ExciteL23
GCCAGCAGTCCGGTGT	ExciteL4
GCCAGCATCTGTCCCA	OPCs
GCCAGGTAGGCCCACT	ExciteL4
GCCAGGTCATGCCGCA	MOLs
GCCAGGTTCAAGAGGC	Microglia
GCCAGTGAGGTCTTTG	Macrophages
GCCAGTGCAGCGTGCT	ExciteL5
GCCATGGCAAGTGTCT	ExciteL4
GCCATGGCAATCGCGC	InhibNeuron
GCCATGGGTGGACCTC	ExciteL4
GCCATGGGTGTTCGTA	InhibNeuron
GCCATGGTCGAGTTGT	MFOLs
GCCATTCCATTCTGTT	ExciteL6
GCCATTCGTAGCTCGC	ExciteL6
GCCATTCTCTATACGG	ExciteL6
GCCCAGACATGTCTAG	MOLs
GCCCAGATCAAGTGGG	ExciteL4
GCCCGAAAGATCCAAA	ExciteL6
GCCCGAACAAAGGCAC	ExciteL23
GCCCGAACAGTAGATA	ExciteL6
GCCCGAACATATCTGG	ExciteL4
GCCCGAAGTCCAGCAC	ExciteL6
GCCCGAAGTCGAGATG	COPs
GCCCGAATCCACCTCA	Astrocytes
GCCCGAATCTTCCCAG	MOLs
GCCGATGAGGTCGTGA	ExciteL6
GCCGATGTCAAGTAAG	OPCs
GCCGATGTCCTATTGT	Macrophages
GCCGTGAAGTCACACT	ExciteL23
GCCGTGAAGTCACTGT	ExciteL4
GCCGTGAGTGCATCTA	OPCs
GCCTGTTAGGAGAGGC	ExciteL4
GCCTGTTAGTCGGCAA	ExciteL4
GCCTGTTAGTGGGAAA	ExciteL5
GCCTGTTCACGCTGTG	InhibNeuron
GCGAGAAAGGCAGGGA	MOLs
GCGAGAACAGTGTGGA	ExciteL4
GCGAGAACATGAGGGT	Pericytes
GCGAGAAGTCACCACG	MOLs
GCGATCGCAGACTCTA	MOLs
GCGATCGGTAGGCTCC	Astrocytes
GCGATCGGTCGAATTC	ExciteL6
GCGATCGGTCGTATGT	ExciteL6
GCGATCGGTGTACAGG	MOLs
GCGATCGGTTCGAAGG	OPCs
GCGGAAACAATTGCCA	MOLs
GCGGAAACACTACACA	Pericytes
GCGGAAAGTTTCGACA	OPCs
GCGGAAATCTCGCGTT	Microglia
GCGGAAATCTTCTTCC	MOLs
GCGGATCGTGGCTGAA	Astrocytes
GCGTGCAAGCAAGTCG	Pericytes
GCGTGCAAGGTACAGC	MOLs
GCGTGCAGTGTATTGC	MOLs
GCGTGCAGTTGTCATG	MOLs
GCGTGCATCGCTCATC	ExciteNP
GCGTGCATCTGTCCCA	Microglia
GCGTTTCAGATGTAGT	MOLs
GCGTTTCAGTCTGGTT	ExciteL4
GCGTTTCTCATCCTGC	ExciteL5
GCTACAAAGTTCATGC	MOLs
GCTACAAGTGACTGAG	ExciteL6
GCTACAATCTCCGAAA	Microglia
GCTACCTCATGTTACG	Microglia
GCTACCTGTACAGGTG	MOLs
GCTCAAACAAAGGTTA	ExciteL6
GCTCAAACAGTGGCTC	MFOLs
GCTCAAATCAAGAAAC	MOLs
GCTCAAATCTCATGCC	InhibNeuron
GCTGAATAGTCCTGTA	Fibroblasts
GCTGAATAGTCTAGCT	Macrophages
GCTGAATCAATAGAGT	ExciteL6
GCTGAATCACGACGTC	ExciteL6
GCTGAATCACTAAACC	ExciteL6
GCTGAATCATCGAAGG	Microglia
GCTGAATGTAGGCTCC	MOLs
GCTGAATTCACATACG	ExciteNP
GCTGAATTCTTCCCGA	ExciteL6
GCTGCAGAGCATGCGA	ExciteL6
GCTGCAGAGTATTAGG	ExciteL6
GCTGCAGAGTCTTCCC	ExciteL4
GCTGCAGGTAGGTTTC	ExciteL6
GCTGCAGGTTCTCTAT	ExciteL4
GCTGCAGTCGAATGCT	InhibNeuron
GCTGGGTCAAGTGTCT	OPCs
GCTGGGTGTATCGGTT	ExciteL6
GCTGGGTTCGCCACTT	MOLs
GCTTCACAGCTGACCC	ExciteL6
GCTTCACCAGCTACAT	Microglia
GCTTCACCAGCTGTTA	ExciteL6
GCTTCACCATCCAATG	OPCs
GCTTCACCATGCTGCG	InhibNeuron
GCTTGGGAGACATCCT	OPCs
GCTTGGGAGACCGCCT	ExciteL4
GCTTGGGAGAGGTCAC	Microglia
GCTTGGGAGCTCACTA	ExciteL6
GCTTGGGCAGCTACAT	ExciteL6
GCTTGGGGTGCTATTG	ExciteL4
GCTTGGGGTGTCACAT	ExciteL6
GCTTGGGTCCGGACTG	ExciteL4
GCTTTCGCACGCGTGT	ExciteL6
GCTTTCGGTGAGGATC	ExciteL6
GCTTTCGTCGTAGTGT	ExciteL6
GGAACCCCAGATTAAG	MOLs
GGAACCCGTACCATAC	ExciteL4
GGAACCCGTCTAGTGT	MOLs
GGAATCTGTTCGAACT	MOLs
GGAATCTTCCAAATGC	Microglia
GGAATGGAGAATAACC	ExciteL4
GGAATGGAGAGCCGAT	MOLs
GGAATGGCAAACTCGT	MOLs
GGAATGGGTGTGTTTG	ExciteL4
GGAATGGTCGCCGATG	Pericytes
GGACGTCAGCAGCACA	MOLs
GGACGTCAGTTCATGC	ExciteL5
GGACGTCCACTTGTCC	OPCs
GGACGTCCATACTGAC	ExciteL6
GGACGTCTCGCCAACG	ExciteL6
GGAGAACTCCCTCGTA	ExciteL4
GGAGAACTCGCATTAG	ExciteL4
GGAGATGAGGACAAGA	ExciteL4
GGAGATGAGGTGATCG	ExciteL6
GGAGATGCATGACTAC	ExciteL6
GGAGATGGTCGCTTAA	ExciteL6
GGAGCAAAGCAATTAG	ExciteL4
GGAGCAAAGCCTATCA	ExciteL6
GGAGCAAAGTGCAGCA	ExciteL5
GGAGCAAAGTTGCTCA	Macrophages
GGAGCAAGTCGCTGCA	Microglia
GGAGCAAGTCTTCCGT	ExciteL6
GGAGCAAGTTAATCGC	ExciteL4
GGAGCAATCCGAGTGC	ExciteL6
GGAGCAATCTAGTGAC	ExciteL6
GGAGGATAGGAGACCT	MOLs
GGAGGATCACCGTGCA	InhibNeuron
GGAGGATCACTTCAGA	MOLs
GGAGGATCAGACCCGT	ExciteL4
GGAGGATGTAATTAGG	Microglia
GGAGGATGTCAAAGCG	ExciteL4
GGAGGATTCTCTCCGA	ExciteL6
GGAGGTACACAATCTG	ExciteL4
GGAGGTACAGTACTAC	Microglia
GGAGGTAGTTATGTGC	OPCs
GGAGGTATCAGAATAG	Astrocytes
GGAGGTATCGATTTCT	ExciteL6
GGATCTAAGCGGATCA	ExciteL4
GGATCTAAGGCGCTTC	ExciteL23
GGATCTACAACATACC	ExciteL5
GGATCTACAGGTTCGC	ExciteL4
GGATCTAGTCAGTCTA	ExciteL4
GGATCTATCAAGCTTG	OPCs
GGATCTATCTTCCGTG	ExciteL6
GGATGTTAGGAACGTC	ExciteL5
GGATGTTCACGTAGAG	MOLs
GGATGTTGTCCAGCGT	ExciteL6
GGATGTTGTTCCGCGA	MOLs
GGATGTTTCACTTGTT	MOLs
GGATGTTTCCGTACGG	ExciteL4
GGCACGTAGCTTTCTT	MOLs
GGCACGTCAAACTCGT	MOLs
GGCACGTCACCGGCTA	ExciteL4
GGCAGTCCAATACGAA	ExciteL6
GGCAGTCTCCACTGGG	Astrocytes
GGCGTCACAGCGAGTA	ExciteL4
GGCGTCATCTGGAGAG	COPs
GGCTGTGAGGAAGTGA	MOLs
GGCTGTGCAAGGGTCA	MOLs
GGCTGTGCAGCAATTC	Microglia
GGCTGTGGTCAACCAT	MOLs
GGCTGTGTCTTACCGC	InhibNeuron
GGCTTGGCAAAGGTTA	OPCs
GGCTTGGCACACGCCA	Astrocytes
GGCTTGGGTCTGCAAT	Microglia
GGCTTGGGTTCGGGTC	MOLs
GGCTTGGTCTATTCGT	ExciteL6
GGCTTTCAGCTGAAAT	MOLs
GGCTTTCAGGTCTGGA	ExciteL6
GGCTTTCTCATGCATG	ExciteL6
GGGAAGTAGACGGTTG	ExciteL4
GGGAAGTCAGAGCTAG	Microglia
GGGACAACAAACTCGT	InhibNeuron
GGGACAATCGCTACAA	Astrocytes
GGGACAATCTTCTCAA	ExciteL6
GGGACCTAGCGTTCAT	Macrophages
GGGACCTGTACAGAGC	Astrocytes
GGGACCTGTCAGTCCG	ExciteL6
GGGACTCCATTGACTG	ExciteL6
GGGACTCTCCGTTGAA	ExciteL6
GGGAGATGTATCGCAT	ExciteL4
GGGAGATTCAAGCCGC	Astrocytes
GGGAGTACAGCCGGTT	ExciteL6
GGGAGTATCTGCTCTG	ExciteL4
GGGATCCAGTTACGGG	MOLs
GGGATCCGTAGTCGGA	ExciteL4
GGGATCCGTATCGTAC	ExciteL4
GGGATCCTCAGCTTGA	ExciteL4
GGGATCCTCCGCAGTG	ExciteL6
GGGATCCTCTTCTGGC	ExciteL4
GGGATGAAGAAGCGGG	ExciteL4
GGGATGAAGCGATGGT	MOLs
GGGATGAAGGCTTTCA	Microglia
GGGATGAAGTCATGCT	Macrophages
GGGATGACACAGAAGC	Microglia
GGGATGACAGTAGTGG	ExciteNP
GGGATGAGTTAGCTAC	MOLs
GGGATGATCTTCCGTG	ExciteL6
GGGCCATCAAAGTGTA	MOLs
GGGCCATTCCCTATTA	Microglia
GGGCGTTAGAAGATCT	ExciteL23
GGGCGTTCAGAGTCTT	Astrocytes
GGGCGTTCATCGTTCC	MOLs
GGGCGTTGTCAGACTT	InhibNeuron
GGGCGTTGTGGTTTGT	OPCs
GGGCGTTTCGGCTGGT	ExciteL6
GGGCTACAGGCCTTCG	MOLs
GGGCTACTCTCTCGCA	ExciteL4
GGGCTCACACCATTCC	ExciteL5
GGGCTCACATATGCGT	Astrocytes
GGGCTCACATGGCGCT	Astrocytes
GGGCTCATCCGTATAG	MOLs
GGGTAGACAGAATCGG	ExciteL23
GGGTAGAGTGGTCTTA	ExciteL4
GGGTAGATCTGCTAGA	ExciteNP
GGGTATTAGAAGTCAT	ExciteL4
GGGTATTAGAGCAGCT	OPCs
GGGTATTAGCTGGCTC	ExciteL6
GGGTATTAGTAGGCCA	InhibNeuron
GGGTATTCACGACAAG	ExciteL23
GGGTATTCAGCTCCTT	Astrocytes
GGGTATTGTTCGTTCC	MOLs
GGGTATTGTTTCGACA	ExciteL5
GGGTATTTCAGTGGGA	ExciteNP
GGGTATTTCCAACCAA	InhibNeuron
GGGTATTTCTCGCTTG	Microglia
GGGTATTTCTGCGGCA	ExciteL4
GGGTCACCAACTCGTA	ExciteL6
GGGTCACCACAAAGCG	MOLs
GGGTCACGTCAAAGCG	ExciteNP
GGGTCACGTCTGTGTA	MOLs
GGGTCACTCTACTTCA	Microglia
GGGTCACTCTTACGGA	Pericytes
GGGTCTGCAAGTTTGC	ExciteL6
GGGTCTGCAGAGTGTG	MOLs
GGGTCTGGTAGGGTAC	InhibNeuron
GGGTCTGTCAGTGTGT	ExciteL6
GGGTGAAAGTATCTGC	Macrophages
GGGTGAAGTGCGTGCT	MOLs
GGGTGTCAGTCCCAAT	ExciteL5
GGGTGTCTCCCAGTGG	ExciteL4
GGGTTATAGTTCTACG	ExciteL6
GGGTTATGTGCATCTA	ExciteL23
GGGTTATTCCTTATGT	ExciteL6
GGTAACTAGCTCACTA	ExciteL4
GGTAACTCAAAGGCGT	ExciteL4
GGTAACTCAAGTGGAC	MOLs
GGTAACTCACGGATCC	ExciteL6
GGTAACTCATGGAACG	Astrocytes
GGTAACTGTCTCACGG	MOLs
GGTAACTGTTGAAGTA	ExciteL4
GGTAACTTCACGGGCT	MOLs
GGTAACTTCCTCAGAA	Astrocytes
GGTAACTTCCTCTGCA	ExciteL4
GGTAATCAGCCACCGT	OPCs
GGTAATCAGGTTATAG	ExciteL4
GGTAATCAGTGTTCCA	ExciteL6
GGTAGAGCAATGTCAC	MOLs
GGTAGAGCACACACGC	ExciteL6
GGTAGAGCAGGCCCTA	ExciteL4
GGTAGAGGTGACACGA	Microglia
GGTCACGCACATCCCT	MOLs
GGTCACGCACCAGCGT	ExciteNP
GGTCACGCATCACGGC	Pericytes
GGTCACGCATGCCGGT	ExciteL23
GGTCACGGTCAACCTA	ExciteL4
GGTCTGGAGCACCAGA	Microglia
GGTCTGGCACTAGGCC	ExciteL6
GGTCTGGCACTGAGGA	ExciteL5
GGTCTGGCAGCGTGAA	ExciteNP
GGTGAAGCACCTGTCT	MOLs
GGTGAAGGTTGTCATG	MFOLs
GGTGAAGTCACGTCCT	ExciteL6
GGTGATTAGTACTGGG	ExciteL4
GGTGATTCAATTGAGA	ExciteL6
GGTGATTGTGAAAGTT	InhibNeuron
GGTGATTTCAGCTCTC	ExciteL4
GGTGATTTCTACGGGC	MOLs
GGTGGCTAGAAGAACG	OPCs
GGTGGCTAGAATCCCT	OPCs
GGTGGCTAGCGAGTAC	InhibNeuron
GGTGGCTAGCGTGTCC	ExciteL4
GGTGGCTAGTAGGCCA	ExciteL4
GGTGGCTCAACCGTAT	OPCs
GGTGGCTTCGGAGCAA	ExciteL4
GGTGTCGAGCAAGTGC	ExciteNP
GGTGTCGCACCCTAGG	Microglia
GGTGTCGCACGGTGCT	MFOLs
GGTGTCGCAGGTCTCG	ExciteL4
GGTGTCGCATGCTGCG	ExciteL6
GGTGTCGTCATTGGTG	ExciteL6
GGTGTCGTCGAGCCTG	ExciteNP
GGTGTTACACGACAAG	OPCs
GGTGTTATCCTCATAT	OPCs
GGTGTTATCCTTCGAC	ExciteL4
GGTGTTATCGTGGTAT	ExciteL4
GGTTAACCAGATTCGT	ExciteL6
GGTTAACTCACTGAAC	ExciteL6
GGTTAACTCGTAGCCG	Astrocytes
GGTTAACTCGTTAGTG	ExciteL4
GGTTCTCCAGGTTCGC	ExciteL5
GGTTCTCCATGAGTAA	ExciteL6
GGTTCTCGTAACATCC	COPs
GGTTCTCGTTAAACCC	MOLs
GGTTGTAAGTCCGTCG	MOLs
GGTTGTACAGGGTCTC	InhibNeuron
GGTTGTAGTGGTAATA	ExciteL4
GGTTGTATCAAATGAG	OPCs
GGTTGTATCGAGCACC	MOLs
GTAACACAGATTGCGG	ExciteL5
GTAACACCACTAACGT	MOLs
GTAACACCATCATCCC	Microglia
GTAACACCATCGTCCT	Endo
GTAACACGTCTGTTAG	Microglia
GTAACACGTTATGTGC	NIPCs
GTAACACTCACTGAAC	MOLs
GTAACCAAGCATTGTC	Pericytes
GTAACCATCCGTAATG	Endo
GTAACCATCGTAGAGG	ExciteL4
GTAAGTCAGAACGCGT	ExciteL6
GTAAGTCAGCTTAAGA	ExciteL6
GTAAGTCCACATTGTG	Microglia
GTAAGTCCATGACGGA	ExciteL6
GTAAGTCTCAGTCACA	MOLs
GTAATCGAGGTGCTTT	MOLs
GTAATCGAGTAGGATT	ExciteL4
GTAATCGCAACGCATT	Astrocytes
GTAATCGCATAGGAGC	ExciteL6
GTAATCGGTGCCTATA	MOLs
GTAATCGGTTAAGGGC	Astrocytes
GTAATCGGTTCTCGCT	ExciteL6
GTAATCGTCACAATGC	ExciteNP
GTAATGCCAACGATTC	MOLs
GTAATGCTCCGTCCTA	ExciteL4
GTAATGCTCTCTTAAC	ExciteL6
GTACAACAGACGCAGT	OPCs
GTACAACGTCGAGTTT	ExciteL23
GTACAACGTCGTATGT	ExciteL6
GTACAACTCACTAGCA	Astrocytes
GTACAACTCCGGACGT	ExciteL4
GTACAACTCCGTGTGG	InhibNeuron
GTACAACTCCTTCTGG	MOLs
GTACAACTCGGTAGAG	ExciteL6
GTACAGTCAAGGTACG	MFOLs
GTACAGTCAAGTTCCA	MOLs
GTAGAAAAGTCTGCAT	ExciteNP
GTAGAAACAGGTGAGT	InhibNeuron
GTAGAAAGTCCGGTGT	MOLs
GTAGAAATCCAGCACG	Microglia
GTAGAGGAGAGAGCCT	ExciteL4
GTAGAGGAGCTAGAGC	Microglia
GTAGAGGCAGATTAAG	ExciteL4
GTAGAGGTCATGAAAG	Microglia
GTAGATCAGGTGCGAT	InhibNeuron
GTAGATCAGTTGTCAC	ExciteL4
GTAGATCTCGGCTATA	ExciteL6
GTAGCTAAGAGCAACC	MOLs
GTAGCTAAGTAAGGGA	ExciteL4
GTAGCTACATTGGGAG	MOLs
GTAGCTAGTTAAGCAA	ExciteL4
GTAGCTATCTGCATAG	Astrocytes
GTAGGAGGTACAATAG	ExciteL5
GTAGGAGGTAGTGTGG	Microglia
GTAGGTTCAAGGGCAT	ExciteL5
GTAGGTTCACGCGTGT	ExciteL5
GTAGGTTCAGCTCCTT	ExciteL4
GTAGGTTGTCTTCGAA	Endo
GTAGTACGTCTCGGAC	COPs
GTAGTACGTGGATCAG	ExciteL6
GTATTGGCACGACCTG	Astrocytes
GTATTGGCATATCTGG	MOLs
GTATTGGGTAGCTCGC	ExciteL6
GTATTGGGTGGGTATG	ExciteL4
GTATTGGTCAAGCGTT	ExciteL5
GTATTTCAGCACTTTG	ExciteL4
GTATTTCCATCTATCT	MOLs
GTATTTCTCTATGCCC	ExciteL6
GTCAAACAGAGCTGAC	ExciteL6
GTCAAACAGATTAGCA	ExciteL4
GTCAAACAGGGTTAAT	ExciteL6
GTCAAACCATCCAACA	ExciteL4
GTCAAACCATCGTGGC	ExciteL4
GTCAAGTCACCCTAAA	MOLs
GTCACGGCACATAACC	ExciteL4
GTCACGGCATTGGGAG	MOLs
GTCACGGGTAAGATCA	ExciteL4
GTCACGGGTTTAGAGA	ExciteL6
GTCACTCAGATTGATG	OPCs
GTCACTCGTTGTGCCG	MOLs
GTCACTCTCCACGGAC	ExciteL4
GTCACTCTCGGCGATC	ExciteL6
GTCACTCTCTGCGAGC	Microglia
GTCAGCGAGAGTCAGC	MOLs
GTCAGCGAGCGTGAGT	MOLs
GTCAGCGCAGGAATCG	Microglia
GTCAGCGTCAGCGCGT	OPCs
GTCAGCGTCTCCAATT	MOLs
GTCAGCGTCTGGGAGA	MOLs
GTCATCCCACTTACAG	ExciteL6
GTCATGAAGCTTAAGA	ExciteL4
GTCATGACAGGATGAC	ExciteL4
GTCATGAGTCCTGTCT	MOLs
GTCATGAGTTCTCGTC	ExciteL6
GTCATTTAGGCTCTAT	MOLs
GTCATTTAGTGCACCC	ExciteL5
GTCATTTGTGCAAGAC	ExciteL4
GTCATTTGTGCGTTTA	ExciteL6
GTCATTTTCGGTAGGA	ExciteL6
GTCCACTAGCGATGAC	ExciteL6
GTCCACTAGGCCATAG	ExciteL6
GTCCACTCATTGTAGC	ExciteNP
GTCCCATAGACGCCAA	ExciteL6
GTCCCATCACGCAAAG	ExciteL5
GTCCCATTCGAGAGAC	MOLs
GTCCTCAGTATGGTAA	Astrocytes
GTCCTCATCCTTACCG	MOLs
GTCGAATCAGGATGAC	InhibNeuron
GTCGAATGTATGAAAC	ExciteL6
GTCGAATGTCCCTAAA	Microglia
GTCGAATGTGGGTATG	OPCs
GTCGAATTCATTACCT	MFOLs
GTCGAATTCCAATCCC	ExciteL5
GTCGAATTCCTCTGCA	ExciteL4
GTCGAATTCTCTGAGA	OPCs
GTCGCGACAGACAAGC	ExciteL6
GTCGCGAGTACGGGAT	ExciteL6
GTCGCGAGTTGAGTCT	ExciteL4
GTCGCGATCGCCAGAC	ExciteL6
GTCGTAAAGACCATTC	Microglia
GTCGTAAAGGTTCAGG	ExciteNP
GTCGTAAAGGTTTACC	Microglia
GTCGTAAAGTGTAGAT	MOLs
GTCGTAAGTAGCTGAG	ExciteL6
GTCGTAAGTCCTTAAG	ExciteL6
GTCGTTCAGCCAGAGT	MOLs
GTCTACCAGACAGTCG	COPs
GTCTACCAGAGCGACT	ExciteL4
GTCTACCCACTCATAG	ExciteL4
GTCTACCGTAACAAGT	ExciteL4
GTCTACCGTCTAACTG	InhibNeuron
GTCTACCTCGGAGTAG	MOLs
GTCTACCTCGTTACCC	Microglia
GTCTACCTCGTTCATT	ExciteL4
GTCTAGAAGTCGCGAA	ExciteL6
GTCTAGACAACTGCCG	ExciteL4
GTCTAGATCCATACAG	ExciteL4
GTCTCACCAAGATGTA	ExciteL6
GTCTCACCATAGGTTC	ExciteL4
GTCTCACCATCGTGGC	InhibNeuron
GTCTGTCTCCGCAACG	Macrophages
GTCTGTCTCGTACACA	ExciteL5
GTCTGTCTCTACCTTA	ExciteL4
GTCTGTCTCTCAGAAC	OPCs
GTCTTTACAGGCGATA	InhibNeuron
GTCTTTAGTAGTTAGA	ExciteL5
GTCTTTAGTCCCAAAT	Macrophages
GTCTTTAGTCGAACGA	Astrocytes
GTCTTTATCGGTCAGC	ExciteL4
GTGACGCAGCCTGTGC	MOLs
GTGACGCCAACCGGAA	ExciteL4
GTGACGCCACTCAAGT	Microglia
GTGACGCCAGTTGCGC	MOLs
GTGACGCCATATTCGG	ExciteL4
GTGACGCTCGGCCTTT	ExciteL6
GTGAGCCAGCCACAAG	MOLs
GTGAGCCAGTTACGTC	ExciteL4
GTGAGCCCAATCTCTT	ExciteNP
GTGAGCCTCCTCTAAT	ExciteNP
GTGAGGAAGCCATCCG	ExciteL4
GTGAGGAAGGCTGTAG	Endo
GTGAGGAAGTAACAGT	ExciteL4
GTGAGTTGTGCGGATA	Microglia
GTGAGTTTCTCGACGG	ExciteL5
GTGATGTAGAGTTCGG	Microglia
GTGATGTAGTATGACA	ExciteL6
GTGATGTCAGTATACC	ExciteNP
GTGATGTCATAATGCC	MOLs
GTGATGTTCCAACCAA	Microglia
GTGATGTTCGACACCG	ExciteL4
GTGCACGAGCTGAGTG	ExciteL4
GTGCACGGTGTCCCTT	ExciteNP
GTGCACGTCTGTGCTC	ExciteL6
GTGCAGCAGCCTCCAG	MOLs
GTGCAGCCACTTTATC	ExciteL5
GTGCAGCGTCCTGTCT	MOLs
GTGCAGCGTGACGTCC	ExciteL4
GTGCAGCTCCGCTAGG	ExciteL6
GTGCAGCTCCGTGTGG	ExciteL5
GTGCAGCTCTTCTAAC	Microglia
GTGCGTGAGAGCAACC	ExciteL6
GTGCGTGAGCGTACAG	ExciteL6
GTGCGTGGTACTCAAC	InhibNeuron
GTGCGTGTCTAGTCAG	InhibNeuron
GTGCTGGCACTACCGG	OPCs
GTGCTTCAGGAAAGGT	Microglia
GTGCTTCCATCAGCAT	ExciteL6
GTGCTTCGTCAACGCC	MOLs
GTGCTTCTCTCATTTG	MOLs
GTGGAAGCACAATGCT	ExciteNP
GTGGAGAAGATGGTAT	Astrocytes
GTGGAGAAGCGAAACC	ExciteL4
GTGGAGAAGGCATCTT	ExciteL4
GTGGAGACACCCTATC	ExciteL6
GTGGAGACAGCCTATA	MOLs
GTGGAGACAGGTATGG	Endo
GTGGCGTAGGAAAGGT	ExciteL5
GTGGCGTCATCGTGCG	MOLs
GTGGCGTCATTGACAC	ExciteL6
GTGGCGTTCTCATTTG	Pericytes
GTGGGAACAATTGCCA	ExciteL4
GTGGGAAGTGAGACCA	ExciteL6
GTGGGAATCCTGCTAC	ExciteNP
GTGGGAATCGTGACTA	MOLs
GTGGTTAAGACGCATG	ExciteL4
GTGGTTAAGCGTACAG	ExciteL6
GTGGTTACACCAGCTG	ExciteL6
GTGGTTACACTTGACA	OPCs
GTGGTTATCGGCACTG	Microglia
GTGGTTATCTTTCCGG	Astrocytes
GTGTAACCAGTTGAAA	ExciteL5
GTGTAACTCCCATAAG	ExciteL6
GTGTCCTCAACCTAAC	OPCs
GTGTCCTGTCAATGGG	InhibNeuron
GTGTCCTGTGTCATTG	ExciteL4
GTGTCCTGTTAGGAGC	ExciteL6
GTGTCCTGTTCCATTT	ExciteL4
GTGTCCTGTTCGTAAC	ExciteL6
GTGTGATAGGCGCTTC	ExciteL6
GTGTGATGTTCGTTCC	Microglia
GTGTGATGTTCTTCAT	Astrocytes
GTGTGGCTCTCTCTTC	Astrocytes
GTGTTAGAGCATTGTC	MOLs
GTGTTAGCAAGGTCTT	MOLs
GTGTTAGCACAAGCAG	ExciteL5
GTGTTAGCACCCTGAG	InhibNeuron
GTGTTAGGTCGACGCT	Pericytes
GTGTTCCAGATGACCG	InhibNeuron
GTGTTCCAGCATTGTC	Astrocytes
GTGTTCCAGCGGGTTA	ExciteL4
GTGTTCCCAGTGCCTG	ExciteL5
GTGTTCCGTCATCGGC	ExciteL4
GTGTTCCGTCTAGGCC	Endo
GTTACAGAGTGCGTCC	MOLs
GTTACAGAGTTGAATG	Pericytes
GTTACAGCACAACCGC	ExciteL6
GTTACAGGTGTTTCTT	Microglia
GTTACCCAGAGAGTGA	MOLs
GTTACCCCAAATAAGC	ExciteL6
GTTACCCCAGACAATA	ExciteL5
GTTACCCCATTGACAC	ExciteL5
GTTACCCGTGAGACGT	ExciteL6
GTTACCCGTTACACTG	InhibNeuron
GTTACCCTCGGATACT	MOLs
GTTACGAAGCCTCTCT	ExciteL5
GTTACGATCGCTAATG	ExciteL6
GTTACGATCGTAGCTA	ExciteL6
GTTAGACGTATAGGGC	ExciteL6
GTTAGACTCAGACCCG	Macrophages
GTTAGACTCTCGAGTA	MOLs
GTTATGGCACCCAATA	ExciteL4
GTTATGGGTGCAATAA	MOLs
GTTATGGTCTCCTGCA	NIPCs
GTTCATTAGGATACGC	ExciteL5
GTTCATTGTCCATACA	MOLs
GTTCCGTTCCTAGAGT	ExciteL4
GTTCGCTAGATCCCGC	Astrocytes
GTTCGCTAGTAACCTC	Astrocytes
GTTCGCTAGTGACACG	ExciteL4
GTTCGCTCAGAGATTA	MOLs
GTTCGCTGTCCAGCCA	Microglia
GTTCTATTCGCGTGAC	MOLs
GTTCTATTCTAAGCCA	ExciteL6
GTTCTATTCTGGTCAA	Endo
GTTGAACTCGGAAGGT	ExciteNP
GTTGAACTCTGTTCAT	ExciteL6
GTTGCGGAGGCGACAT	MOLs
GTTGCGGCAGTCTCTC	Microglia
GTTGCTCAGCTTTCCC	MOLs
GTTGCTCCAATCGAAA	ExciteL4
GTTGCTCCACATGAAA	ExciteL4
GTTGCTCCAGACCAAG	ExciteL6
GTTGCTCGTCAAGTTC	Endo
GTTGTAGCACTAGTAC	MOLs
GTTGTAGGTAGTCTTG	Microglia
GTTGTAGGTTGCCATA	MOLs
GTTGTAGTCAGGAACG	ExciteL6
GTTGTAGTCTCGACGG	ExciteL6
GTTGTCCCAGTATACC	ExciteL4
GTTGTCCCATTGACAC	MOLs
GTTGTCCGTAAGTTGA	Microglia
GTTGTCCGTTTCTTAC	ExciteL4
GTTGTCCTCCCGAGGT	ExciteL6
GTTGTCCTCCGCAGTG	ExciteL5
GTTGTGAAGCTTTCCC	ExciteL6
GTTGTGAAGGCTAAAT	ExciteL4
GTTGTGAAGTGGAAAG	OPCs
GTTGTGATCAAACGTC	MOLs
GTTTACTAGGAAGTCC	ExciteL5
GTTTGGATCCAATGCA	ExciteL4
GTTTGGATCCACACCT	ExciteL6
TAACACGCAGTTCCAA	OPCs
TAACACGGTACCCGCA	ExciteL6
TAACCAGAGATCCGAG	OPCs
TAACCAGAGCTTAAGA	ExciteL4
TAACCAGCATCGGTTA	MOLs
TAACCAGTCTGAACGT	OPCs
TAACCAGTCTGAGGCC	ExciteL4
TAACGACAGCGAGAAA	COPs
TAACGACCAAGCTCTA	ExciteL4
TAACGACGTAAGATCA	ExciteL6
TAACGACTCGCGATCG	COPs
TAACTTCCACGTAGAG	ExciteL6
TAACTTCCACTGGATT	Pericytes
TAACTTCCATTCTCTA	MOLs
TAACTTCGTAGTGGCA	Astrocytes
TAACTTCTCATCGGGC	OPCs
TAAGCACGTATTCTCT	OPCs
TAAGCACGTCCTGGGT	MOLs
TAAGCACTCCGCTTAC	ExciteL4
TAAGCCAAGAGTGAAG	MOLs
TAAGCCACAAAGGGCT	ExciteL4
TAAGCCACATTATGCG	ExciteL6
TAAGCCAGTGGATCGA	Pericytes
TAAGCCAGTGTTGAGG	Astrocytes
TAAGCGTAGAGTTGAT	Pericytes
TAAGCGTGTCCCACGA	ExciteL23
TAAGTCGAGGCTAACG	MOLs
TAAGTCGCAAGACCTT	Macrophages
TAAGTCGCAGCCGTCA	MOLs
TAATCTCAGAACGTGC	ExciteL6
TAATCTCAGATGTTCC	ExciteNP
TAATCTCCAGCGTGCT	MOLs
TAATCTCCATGAGAAT	ExciteL6
TAATCTCTCTTGGATG	Macrophages
TAATTCCTCAGAGCGA	ExciteL6
TAATTCCTCGTTCTAT	ExciteL4
TAATTCCTCTGGGCGT	MOLs
TAATTCCTCTTGGGCG	OPCs
TACAACGAGAATAACC	ExciteL5
TACAACGAGCACTCTA	ExciteNP
TACAACGAGGCTAGCA	ExciteL6
TACAACGAGTGCTACT	OPCs
TACAACGCAGGAGGTT	ExciteL6
TACAACGCAGTATGAA	ExciteL4
TACACCCAGACAGTCG	OPCs
TACACCCAGCCTTTGA	ExciteNP
TACACCCCAAATCCCA	OPCs
TACACCCCAAGTGGTG	ExciteL6
TACACCCGTGTTCCTC	MOLs
TACACCCGTTAAAGTG	MOLs
TACAGGTAGTATAGGT	ExciteL4
TACAGGTCAGAATTCC	ExciteL4
TACAGGTGTCTACAGT	ExciteL6
TACAGGTGTGACGTCC	ExciteL6
TACAGGTTCTACCACC	InhibNeuron
TACAGGTTCTCAATCT	ExciteL6
TACATTCAGGCTTAGG	OPCs
TACATTCAGGTTGGTG	InhibNeuron
TACATTCAGTCTGGTT	Microglia
TACATTCAGTGTTGAA	Microglia
TACATTCGTAATGTGA	Astrocytes
TACCCACAGCGATTCT	ExciteL4
TACCCACAGGTCTTTG	ExciteL4
TACCCACAGGTGTGAC	InhibNeuron
TACCCACAGTACTGGG	ExciteL6
TACCCACAGTAGTCAA	InhibNeuron
TACCCACCAACCACGC	InhibNeuron
TACCCACCATGCCGGT	Microglia
TACCCACGTCCTGTTC	Astrocytes
TACCCACTCATCCCGT	InhibNeuron
TACCCACTCTCGGGAC	OPCs
TACCCGTAGGGCAATC	ExciteL6
TACCCGTAGGGCTAAC	MOLs
TACCCGTAGTGGTTGG	Microglia
TACCCGTAGTTACGGG	ExciteNP
TACCCGTCACCTGTCT	OPCs
TACCCGTCATGAGATA	Astrocytes
TACCCGTGTAAGGCCA	ExciteL5
TACCCGTTCATGCCGG	OPCs
TACCCGTTCCGAGAAG	ExciteL4
TACCCGTTCCGTAATG	MOLs
TACCGAAAGCGATGGT	MOLs
TACCGAACATAAGCAA	MOLs
TACCGAAGTGTTAAAG	ExciteL6
TACCGAAGTTATTCTC	ExciteNP
TACCGAATCGATCCAA	ExciteL4
TACCGGGAGCTTTCCC	ExciteL6
TACCGGGCAGTCTTCC	ExciteL6
TACCGGGTCGGTGTTA	ExciteL4
TACCTCGTCTTCTGTA	COPs
TACCTGCAGGCATCGA	ExciteL4
TACCTGCCAAGGTCTT	ExciteL6
TACCTGCCAATCGTCA	Macrophages
TACCTGCTCGGTCGAC	InhibNeuron
TACGCTCAGCACTCAT	Macrophages
TACGCTCCAATCTCGA	ExciteL5
TACGCTCGTGAAAGTT	ExciteL6
TACGCTCGTTGGAGGT	ExciteL23
TACGCTCGTTTACGTG	Microglia
TACGCTCTCGACCACG	MOLs
TACGGGCAGAAGCCAC	OPCs
TACGGGCCAACACTAC	Macrophages
TACGGGCCAGGCTTGC	Astrocytes
TACGGTAAGTGCGCTC	Astrocytes
TACGGTAGTCGCAACC	Macrophages
TACGGTAGTTGGCCGT	MOLs
TACGGTATCCATAGGT	Microglia
TACGGTATCCGCGATG	MOLs
TACGGTATCTCTCGCA	ExciteL4
TACGTCCTCTCGCTTG	MOLs
TACTGCCAGCCATCCG	ExciteL4
TACTGCCAGGACAGTC	ExciteL4
TACTGCCCAGGGACTA	Pericytes
TACTGCCGTAACGCGA	ExciteL4
TACTGCCGTATACGGG	Macrophages
TACTGCCTCCCTTGGT	InhibNeuron
TACTTACAGGCCTTCG	ExciteL6
TACTTACCACATACGT	ExciteL6
TACTTACCAGTGGTGA	Microglia
TACTTACCATGGCTGC	Macrophages
TACTTACGTCTCGGGT	Microglia
TACTTACTCGGATAAA	InhibNeuron
TACTTCACAGATCATC	MOLs
TACTTCACATGCACTA	ExciteNP
TACTTGTAGCGCTGCT	Astrocytes
TACTTGTCAGGACTAG	OPCs
TACTTGTCATGCAGGA	ExciteL4
TACTTGTGTTGCCATA	ExciteL4
TACTTGTTCATCGCCT	Pericytes
TACTTGTTCATTTACC	ExciteL4
TAGACCAAGGTTTGAA	ExciteL23
TAGACCACAAAGGCAC	Pericytes
TAGACCACAAATGAAC	Macrophages
TAGACCATCTACAGGT	Endo
TAGACTGCATCGCTAA	MOLs
TAGACTGTCTGTCCGT	ExciteNP
TAGAGTCCACGATAGG	MOLs
TAGAGTCTCGCGTGAC	ExciteL4
TAGATCGAGACTCATC	Microglia
TAGATCGCAACCGATT	ExciteL6
TAGATCGGTGTATCCA	ExciteL6
TAGCACAAGATAGGGA	Pericytes
TAGCACACAAGCGAAC	InhibNeuron
TAGCACACACCGGTCA	MOLs
TAGCACAGTAACTAAG	ExciteL6
TAGCACAGTTGCTTGA	MOLs
TAGCACATCCGGCAAC	Microglia
TAGGAGGCAAACTAAG	ExciteL4
TAGGAGGCACAGAAGC	ExciteL6
TAGGAGGCAGGACGAT	ExciteL4
TAGGAGGCATCGGTTA	Microglia
TAGGAGGGTATTGAGA	ExciteL6
TAGGAGGGTTCGAGCC	ExciteL6
TAGGAGGGTTTACGAC	Microglia
TAGGAGGTCCGCGAGT	MOLs
TAGGGTTAGGCTTAAA	ExciteL4
TAGGGTTCATTACTCT	MOLs
TAGGGTTTCACGATCA	Microglia
TAGGTACAGCGTATAA	ExciteL6
TAGGTACAGCTAGTTC	ExciteL4
TAGGTACAGTTGCCTA	ExciteNP
TAGGTACCAAGCCCAC	ExciteNP
TAGGTACGTAGTTCCA	ExciteL6
TAGGTACGTCATCTAG	ExciteL6
TAGGTACTCCACTAGA	COPs
TAGGTTGCATGAATAG	ExciteL23
TAGGTTGGTGTTGACT	Pericytes
TAGGTTGTCATGTCTT	ExciteL6
TAGTGCACAGTTCTAG	MOLs
TAGTGCAGTTTGAACC	Microglia
TATACCTAGCGACATG	MOLs
TATACCTTCTATCGTT	ExciteL6
TATATCCCAGAAACCG	ExciteL4
TATATCCGTAGGCTGA	OPCs
TATATCCGTGAGAACC	ExciteL4
TATATCCGTGAGACGT	Macrophages
TATCAGGAGCAACCAG	ExciteL4
TATCAGGAGTATGTAG	Astrocytes
TATCAGGCACCATAAC	ExciteL4
TATCAGGCACCCATAA	ExciteL4
TATCAGGCAGCGTGCT	ExciteL6
TATCAGGGTTACCCAA	ExciteL4
TATCAGGGTTCGATTG	Astrocytes
TATCAGGTCTACGCAA	ExciteL6
TATCCTAAGCAGTACG	ExciteL6
TATCCTAAGGGTAGCT	ExciteL4
TATCCTAAGTAGTGCG	ExciteL4
TATCCTATCCTAGCTC	InhibNeuron
TATCGCCTCCACACCT	ExciteL4
TATCGCCTCTGAATCG	Astrocytes
TATCTTGCATACAGAA	MOLs
TATCTTGGTTAAGAAC	ExciteL4
TATCTTGTCCGATTAG	MOLs
TATCTTGTCGTGTGAT	Pericytes
TATGTTCCAAATCGTC	ExciteL4
TATGTTCGTTTCTATC	Astrocytes
TATTCCAAGGCTGGAT	OPCs
TATTCCACAGAGTTGG	MOLs
TATTCCAGTGACACGA	MOLs
TATTCCATCCTGTTGC	Astrocytes
TATTCCATCGTAACCA	ExciteL4
TATTGCTAGCCTATCA	ExciteL5
TATTGCTAGGGTACAC	ExciteL4
TATTGCTCACGGATCC	ExciteL6
TATTGCTCACGTATAC	Microglia
TATTGCTGTGTCGCTG	Macrophages
TATTGCTTCATAAGGA	Astrocytes
TATTGCTTCTCCCATG	ExciteL4
TATTGGGAGGGTCACA	ExciteL5
TATTGGGCAGCGATTT	ExciteL4
TATTGGGGTCCGATCG	ExciteL4
TATTGGGGTGTTCGTA	OPCs
TATTGGGTCTATGCCC	COPs
TATTTCGAGGCAGCTA	MOLs
TATTTCGCAGCGTGAA	ExciteL6
TATTTCGCATCAACCA	ExciteL5
TATTTCGGTGGGTCAA	MOLs
TCAAGACAGTCGAATA	ExciteL4
TCAAGACCACGATAGG	ExciteL6
TCAAGACCAGTCGGTC	ExciteL6
TCAAGACGTCGATTCA	ExciteL6
TCAAGACTCATGCTAG	ExciteL6
TCAAGACTCGATGGAG	ExciteL6
TCAAGACTCGCTTGCT	ExciteL4
TCAAGACTCTATTGTC	ExciteL6
TCAAGACTCTCAGAAC	MOLs
TCAAGACTCTGCGGGT	ExciteL4
TCAAGCAAGTTGCTGT	MOLs
TCAAGCACACGCTTAA	ExciteL4
TCAAGCAGTTCGAACT	ExciteL4
TCAAGCATCCAAACCA	ExciteL4
TCAAGCATCCATCACC	MOLs
TCAAGTGAGAGGCGTT	ExciteL6
TCAAGTGAGATCCAAA	Astrocytes
TCAAGTGCACGTCGGT	ExciteL4
TCAAGTGCAGGTCAAG	MOLs
TCAAGTGCATGCTGCG	Microglia
TCAAGTGGTGGATTTC	MOLs
TCAAGTGTCCACTGAA	InhibNeuron
TCAAGTGTCTGGTGCG	MOLs
TCAATCTAGTCAGCGA	Microglia
TCAATCTCAATAGGGC	ExciteL4
TCAATCTCAGCAGAAC	ExciteL6
TCAATCTGTAGCGTAG	MOLs
TCAATTCTCAGATGCT	OPCs
TCACAAGAGCGTGCTC	ExciteL6
TCACAAGAGGACAAGA	MOLs
TCACAAGAGTCTTCCC	MOLs
TCACAAGGTCGCAGTC	ExciteL4
TCACAAGTCATGTCTT	ExciteL6
TCACAAGTCTCCGCAT	Pericytes
TCACAAGTCTGGTGCG	InhibNeuron
TCACACCAGGTACAAT	ExciteL4
TCACACCCACACCTAA	ExciteL4
TCACACCCACCAAATC	InhibNeuron
TCACACCGTTGCGTAT	InhibNeuron
TCACATTAGTCTCTGA	MOLs
TCACATTCAAGCAATA	MOLs
TCACATTCATAGACTC	MOLs
TCACATTGTCCCTAAA	ExciteL6
TCACATTTCTACGGGC	Microglia
TCACGCTAGAAACCCG	Astrocytes
TCACGCTGTACGTTCA	Microglia
TCACGCTTCCCGATCT	ExciteL23
TCACGGGAGTGATTCC	ExciteL4
TCACGGGCAGTAACCT	MOLs
TCACGGGTCAATGCAC	ExciteL4
TCACGGGTCATCTCTA	MOLs
TCACTATAGCATAGGC	OPCs
TCACTATAGTTACGAA	ExciteL4
TCACTATTCTCGCTTG	OPCs
TCACTCGCAAGGCGTA	MOLs
TCACTCGGTAGTTAGA	ExciteNP
TCAGCAAAGTGCAACG	ExciteL6
TCAGCAATCACCACAA	ExciteL4
TCAGCAATCGCTGACG	ExciteL6
TCAGCCTCATCTCGTC	Microglia
TCAGCCTGTAGGGAGG	ExciteL6
TCAGCCTGTCACCTTC	ExciteL5
TCAGCCTGTTAAGACA	Macrophages
TCAGGGCCAAAGCTAA	ExciteL6
TCAGGGCGTGAATATG	ExciteL4
TCAGGGCGTGGCAGAT	MOLs
TCAGGGCTCTGGGAGA	MOLs
TCAGGTAAGGGCTTCC	OPCs
TCAGGTACAGTAACCT	ExciteL6
TCAGGTAGTATCGTTG	ExciteL4
TCAGTCCAGGGAACAA	MOLs
TCAGTCCAGTTGCTGT	ExciteL6
TCAGTCCCAGGTCAAG	ExciteL4
TCAGTCCCAGTCTGGC	OPCs
TCAGTCCGTCTCGGAC	Astrocytes
TCAGTCCTCGAGAGAC	ExciteL6
TCAGTGAAGCCTCACG	Astrocytes
TCAGTGACACATGAAA	ExciteL4
TCAGTGATCACTAGCA	MOLs
TCAGTTTAGCAATTCC	MOLs
TCAGTTTAGGAACTCG	ExciteL6
TCAGTTTCACGACGTC	Microglia
TCAGTTTCATCTATCT	ExciteL5
TCAGTTTGTCATCAGT	OPCs
TCAGTTTTCACTGTTT	ExciteL6
TCATACTAGACCTCCG	Microglia
TCATACTAGCACTCTA	InhibNeuron
TCATACTCAATACCTG	ExciteL6
TCATACTGTCTACAGT	Astrocytes
TCATACTGTTGTTTGG	ExciteL6
TCATACTTCCACGGGT	Astrocytes
TCATACTTCTCATAGG	ExciteL4
TCATATCAGGTATTGA	ExciteL4
TCATATCCAATCGCAT	ExciteL5
TCATATCTCCACGTCT	ExciteL4
TCATCATTCACGATCA	ExciteL4
TCATCATTCTGCTGAA	ExciteL6
TCATCCGAGCCATTGT	Pericytes
TCATCCGTCCACAGGC	ExciteL4
TCATCCGTCGGCACTG	ExciteL5
TCATCCGTCGTGGTAT	NIPCs
TCATGAGAGCAACCAG	Pericytes
TCATGAGCAGAAACCG	ExciteL6
TCATGAGGTGTATTGC	MOLs
TCATGAGTCCTTACCG	OPCs
TCATGCCAGTTACGTC	ExciteL4
TCATGCCCACGACGCT	MOLs
TCATGCCCATGGAATA	MOLs
TCATGCCCATTGCTTT	ExciteL6
TCATGCCGTGTTGCCG	ExciteL4
TCATGGACATATCTGG	ExciteL4
TCATGGACATGCACTA	ExciteL6
TCATGGATCTTCCACG	InhibNeuron
TCATGTTAGGAAAGAC	InhibNeuron
TCATGTTAGGGTGAGG	Microglia
TCATGTTCACCAGCCA	ExciteL23
TCATGTTTCATTGGTG	ExciteL4
TCATTACTCGTACCTC	ExciteL5
TCATTCAGTCATTCCC	ExciteL4
TCATTGTCACGGTAGA	MOLs
TCATTGTTCAACCTCC	OPCs
TCATTTGAGATTGGGC	MOLs
TCATTTGAGGTGCTAG	ExciteL4
TCATTTGGTCCGATCG	MOLs
TCCACCAAGCTTTCTT	ExciteL6
TCCACCATCCGTAGTA	MOLs
TCCACGTAGCATTGAA	ExciteL6
TCCACGTCAAGAGAGA	ExciteL4
TCCAGAAAGACGATAT	NIPCs
TCCAGAAAGCTCACTA	MOLs
TCCAGAACAACGATTC	MOLs
TCCAGAACAGCTCCTT	Microglia
TCCAGAACATAACAGA	OPCs
TCCAGAACATATGGCT	Macrophages
TCCAGAACATGACGTT	MOLs
TCCAGAAGTTTCGGCG	ExciteL4
TCCATCGAGGAGCAAA	MOLs
TCCATCGAGTATTCCG	MOLs
TCCATCGCAGGTCCCA	ExciteL4
TCCATCGTCGCGCCAA	Microglia
TCCATGCAGTTACTCG	ExciteL4
TCCATGCCACCCTGAG	ExciteL6
TCCATGCGTAACAGTA	InhibNeuron
TCCATGCGTAGCTAAA	ExciteL4
TCCATGCGTTATCTGG	Endo
TCCATGCGTTGCGGCT	MOLs
TCCCACAAGCTTCGTA	ExciteL6
TCCCACACACGCAAAG	MOLs
TCCCACATCCTTATAC	ExciteL6
TCCCAGTAGCCTAACT	Astrocytes
TCCCAGTAGCGAATGC	ExciteL6
TCCCAGTAGCGATTCT	Microglia
TCCCAGTAGTCGCCAC	ExciteL6
TCCCAGTTCTGTCTCG	Astrocytes
TCCCATGAGCCTGAAG	ExciteL4
TCCCATGCATGAAAGT	ExciteL4
TCCCATGGTCGGCTAC	Microglia
TCCCATGTCCGAGTGC	ExciteL6
TCCCATGTCGACCAAT	ExciteL6
TCCGAAAAGGTTCCAT	ExciteL4
TCCGAAAGTAGAGATT	OPCs
TCCGAAAGTTCCGTTC	ExciteL4
TCCGAAATCACTCGAA	Microglia
TCCGATCAGCCTCGTG	ExciteL6
TCCGATCCAATAACGA	Macrophages
TCCGATCGTAGGTAGC	ExciteL6
TCCGGGAAGGAACTAT	MOLs
TCCGGGACAAATGCGG	ExciteL5
TCCGGGACAGTCGCTG	MOLs
TCCGGGAGTCTTGAGT	ExciteL4
TCCGTGTGTGACATCT	MOLs
TCCTAATTCTACCAGA	Microglia
TCCTCCCAGCGCCTCA	MOLs
TCCTCCCAGTTGGCTT	Microglia
TCCTCCCTCCCTCATG	Macrophages
TCCTCGACACCGTGAC	ExciteL4
TCCTCGACATCAGCGC	MOLs
TCCTCGATCCAGTGTA	ExciteL6
TCCTCTTAGTTACTCG	ExciteL6
TCCTCTTTCATTACTC	Pericytes
TCCTCTTTCTAAGCGT	Microglia
TCCTCTTTCTCCGTGT	ExciteL4
TCCTCTTTCTTGATTC	ExciteL5
TCCTGCAAGACCCGCT	MOLs
TCCTGCAAGGCACCAA	ExciteL6
TCCTGCAAGTGCCTCG	MOLs
TCCTGCACAACCCGCA	Macrophages
TCCTGCACAATCTGCA	Microglia
TCCTGCACACTGTGAT	Microglia
TCCTGCACAGGACTAG	MOLs
TCCTGCACAGTGTGCC	ExciteL6
TCCTTCTGTATCAGGG	Macrophages
TCCTTCTTCATCGCCT	OPCs
TCCTTCTTCGCAGTGC	ExciteL4
TCCTTTCAGATTACCC	ExciteL6
TCCTTTCAGGAAGTGA	ExciteL23
TCCTTTCCAAATCAAG	MOLs
TCCTTTCCAACGACAG	Macrophages
TCCTTTCCACCTGCGA	Macrophages
TCCTTTCGTTCTCGTC	ExciteL4
TCGAACAAGACTCATC	MOLs
TCGAACAGTGCTCTTC	Microglia
TCGAACATCAAGATAG	MOLs
TCGAACATCTGTTCAT	COPs
TCGAAGTAGTCCCGGT	COPs
TCGACCTAGGCTTAAA	ExciteL4
TCGACCTCAAGCTGCC	Astrocytes
TCGACCTCAGTATTCG	Astrocytes
TCGACCTGTCCAGTTA	Astrocytes
TCGACCTGTGGGTATG	COPs
TCGACGGAGTCATGCT	MOLs
TCGACGGAGTGGAATT	ExciteL6
TCGACGGCAACTCATG	ExciteL6
TCGACGGCAAGCAGGT	Astrocytes
TCGACGGGTGAATAAC	Astrocytes
TCGACGGGTTGGCCTG	MOLs
TCGATTTAGTAGTCCT	MOLs
TCGATTTGTGTCTCCT	ExciteL4
TCGATTTGTTCTCTAT	MOLs
TCGATTTTCGCGTAGC	ExciteL6
TCGCACTAGAGGGCGA	ExciteL5
TCGCACTCAGTAGTTC	MOLs
TCGCACTGTACCTATG	ExciteL4
TCGCACTGTACGCGTC	MFOLs
TCGCACTGTCAACACT	OPCs
TCGCACTGTGAAGCTG	InhibNeuron
TCGCAGGCACTATGTG	InhibNeuron
TCGCAGGCATACTGTG	ExciteL4
TCGCAGGGTCCTTGTC	ExciteL6
TCGCAGGGTCGCATGC	ExciteL4
TCGCAGGGTTTACTTC	MOLs
TCGCTCAAGTCAGAGC	MOLs
TCGCTCAAGTTACGAA	ExciteL4
TCGCTCAGTACAATAG	Microglia
TCGCTCATCAGACAAA	ExciteL5
TCGCTCATCATCCTGC	MOLs
TCGCTCATCGTGAGAG	ExciteL5
TCGCTTGAGAGCATCG	ExciteL4
TCGCTTGAGATAACGT	Astrocytes
TCGCTTGCATCGATGT	ExciteL4
TCGCTTGGTGACTCGC	MOLs
TCGCTTGGTTCTCTCG	ExciteL4
TCGCTTGTCTCAACGA	ExciteL4
TCGGATACACAGCTGC	ExciteL6
TCGGATACAGTTTCAG	MOLs
TCGGGACGTATCGAGG	ExciteL4
TCGGGACGTGTGACCC	MOLs
TCGGGACTCTACGCGG	ExciteL5
TCGGGCAAGCCTCTGG	MOLs
TCGGGCACACCCTTAC	MOLs
TCGGGCATCTCACTCG	ExciteL5
TCGGGTGCAATATCCG	InhibNeuron
TCGGGTGCAGAAGTTA	InhibNeuron
TCGGGTGCATTACGGT	MOLs
TCGGGTGGTAGTGGCA	Astrocytes
TCGGGTGGTTCGTGCG	ExciteL4
TCGGGTGTCACCTCGT	Astrocytes
TCGGGTGTCCCAGTGG	ExciteL23
TCGGGTGTCGCATAGT	ExciteL6
TCGGGTGTCTTCACGC	ExciteL4
TCGGGTGTCTTCGTGC	ExciteL4
TCGGTCTGTCCCTCAT	MOLs
TCGGTCTGTGTAACGG	ExciteL4
TCGTAGAAGATGGTCG	Microglia
TCGTAGAGTAACATCC	COPs
TCGTAGAGTGTCTAAC	InhibNeuron
TCGTAGATCGGAATGG	Microglia
TCGTAGATCTGTCCGT	ExciteL4
TCGTCCAAGCAACAGC	MOLs
TCGTCCAAGGTTGTTC	InhibNeuron
TCGTCCACAACGATCT	Pericytes
TCGTCCACAGCTTTGA	ExciteL6
TCGTCCACATGCAGGA	Astrocytes
TCGTCCAGTATGTCCA	Astrocytes
TCGTCCAGTCGTCATA	ExciteL5
TCGTCCAGTGAGCCAA	ExciteL6
TCGTCCATCTCAGTCC	Microglia
TCGTGCTCACTGCGAC	Microglia
TCGTGCTGTATGGAAT	InhibNeuron
TCGTGCTTCATCACTT	ExciteL4
TCGTGCTTCCACCTCA	Microglia
TCGTGGGAGACGACGT	Microglia
TCGTGGGCAAACCGGA	Astrocytes
TCGTGGGGTCAGCGTC	ExciteL6
TCGTGGGTCAGTGGGA	ExciteL5
TCGTGGGTCGTTCCCA	Astrocytes
TCTAACTAGAATCCCT	ExciteNP
TCTAACTAGATTGACA	Pericytes
TCTAACTAGCTAATCC	ExciteL6
TCTAACTCACTCCTTG	ExciteL4
TCTAACTGTTATAGCC	ExciteL4
TCTAACTTCAGCGCGT	MOLs
TCTACATCAGTCCGTG	ExciteL4
TCTACATGTAGAGCTG	ExciteL6
TCTACCGAGATTGCGG	ExciteL4
TCTACCGGTCGAATTC	OPCs
TCTACCGTCCGACATA	InhibNeuron
TCTACCGTCCTATGGA	MOLs
TCTACCGTCGCCGAAC	ExciteL4
TCTATACCAAGGTCAG	ExciteL6
TCTATACGTATGCGGA	MOLs
TCTATACTCCCAAGTA	MOLs
TCTATCAAGGATATAC	ExciteL4
TCTATCACAATGCAGG	Astrocytes
TCTATCAGTTGCCTAA	Astrocytes
TCTCACGAGAGCATCG	Astrocytes
TCTCACGAGATTAGAC	Microglia
TCTCACGAGTTGGCGA	MOLs
TCTCACGCAATTGTGC	Pericytes
TCTCACGGTTCTCGTC	MOLs
TCTCACGTCCAACTGA	ExciteL4
TCTCAGCAGATGACCG	ExciteL4
TCTCAGCCAACTGGTT	Astrocytes
TCTCAGCGTCCGGTGT	OPCs
TCTCCGACAAGTCCAT	ExciteL4
TCTCCGACAGATCACT	OPCs
TCTCCGAGTGTCCATA	ExciteL4
TCTCCGATCCAATGCA	Astrocytes
TCTCTGGAGGCAGCTA	ExciteL4
TCTCTGGAGGCCTTGC	OPCs
TCTCTGGCACCCTGAG	ExciteL4
TCTCTGGCAGACCTAT	ExciteL6
TCTGCCAAGCGTTACT	Astrocytes
TCTGCCAGTCGCACAC	ExciteL4
TCTGCCATCAAGAATG	ExciteL4
TCTGGCTAGGCACTAG	COPs
TCTGGCTAGTCCGCCA	Microglia
TCTGGCTCAAGTGCAG	ExciteL5
TCTGGCTGTCTCAAGT	OPCs
TCTGGCTTCGAGAGAC	ExciteL4
TCTGTCGAGAGTGGCT	MOLs
TCTGTCGAGGCTAAAT	Astrocytes
TCTGTCGCAAACCATC	MOLs
TCTGTCGCATACCGTA	Pericytes
TCTGTCGTCAGGACGA	ExciteL5
TCTTAGTAGGCCTAAG	Microglia
TCTTAGTCAACGGGTA	ExciteL6
TCTTGCGAGCCTAGGA	ExciteL4
TCTTGCGCAAACGGCA	ExciteL4
TCTTGCGGTCTCCCTA	ExciteL4
TCTTGCGTCAGATGCT	ExciteL4
TCTTGCGTCGTTCCTG	ExciteL23
TCTTGCGTCTAGTACG	ExciteL6
TCTTTGAAGCCTATTG	Astrocytes
TCTTTGAAGGTTGGTG	InhibNeuron
TCTTTGACACAGCATT	ExciteL6
TGAACGTAGACGATAT	ExciteL4
TGAACGTAGAGGCGTT	Microglia
TGAACGTCAGGGATAC	ExciteL4
TGAACGTTCGTGCACG	ExciteL4
TGAACGTTCTAGTCAG	Macrophages
TGAACGTTCTGACCCT	Microglia
TGAATCGAGCGTTGTT	MOLs
TGAATCGTCTGCTTTA	Microglia
TGAATGCAGATAGCAT	ExciteL4
TGAATGCAGTACCGGA	MOLs
TGACAGTCATCAGTGT	ExciteL5
TGACCCTAGACGGATC	ExciteL6
TGACCCTAGCAACCAG	Pericytes
TGACCCTAGGCGCTTC	ExciteL4
TGACCCTCAGTGTGGA	ExciteL5
TGACCCTTCTGCAGCG	Astrocytes
TGACGCGAGATCACCT	MOLs
TGACGCGAGCGTGAGT	ExciteL5
TGACGCGAGTGGTGAC	ExciteL4
TGACGCGCAACATACC	ExciteL5
TGACTCCAGCGATGGT	MOLs
TGACTCCTCGAGAGAC	ExciteL6
TGAGACTAGGAAGAAC	ExciteL4
TGAGACTAGGACTATA	ExciteL6
TGAGCATGTATGATCC	ExciteL23
TGAGCATGTCATGGCC	InhibNeuron
TGAGCATGTTGTGGCC	COPs
TGAGCGCGTTGGAGGT	ExciteL4
TGAGCGCTCTTACTGT	MOLs
TGAGGAGGTTCTGACA	ExciteL6
TGAGGAGTCCGTGCGA	ExciteL6
TGAGGAGTCGTACACA	ExciteL4
TGAGGGAAGGATCACG	Microglia
TGAGGGACAACACGTT	OPCs
TGAGGGACATCTAGAC	Microglia
TGAGGGAGTCGCATGC	ExciteL4
TGAGGGATCTATTGTC	ExciteL6
TGAGGGATCTTGGGCG	ExciteL6
TGAGGTTAGCTGTTAC	ExciteL4
TGAGGTTAGTCCGCCA	ExciteNP
TGAGGTTGTGGCTACC	Microglia
TGAGGTTTCGAGTGAG	ExciteL4
TGAGTCAAGGTTCACT	OPCs
TGAGTCACAATAACCC	ExciteL6
TGAGTCACAGGCGTTC	ExciteL4
TGAGTCACAGTAACAA	ExciteL4
TGAGTCACATCTCATT	MOLs
TGAGTCATCAATCTTC	ExciteL4
TGAGTCATCAGGACGA	ExciteL4
TGAGTCATCATCCTGC	ExciteL6
TGATCAGAGATTTGCC	ExciteL6
TGATCAGAGCAACTCT	InhibNeuron
TGATCAGAGGTACTGG	InhibNeuron
TGATCAGTCCGGCAGT	MOLs
TGATCAGTCCTCTAGC	OPCs
TGATCAGTCTTTGGAG	ExciteL6
TGATCTTAGACTGTTC	ExciteL23
TGATCTTCAATAGAGT	ExciteL6
TGATCTTTCCCGAATA	Astrocytes
TGATGCACAAGCCTGC	Macrophages
TGATGCACAAGTCCCG	ExciteL6
TGATGCATCTGGCCAG	ExciteL4
TGATGGTAGTGCCGAA	ExciteL4
TGATGGTGTATGACAA	ExciteL4
TGATGGTGTCCTGGGT	OPCs
TGATGGTGTCTACTGA	ExciteL4
TGATGGTTCGCGTTTC	ExciteL6
TGATGGTTCTGTCCGT	ExciteL4
TGATTCTAGCCGATCC	Microglia
TGATTCTGTGGATACG	ExciteL6
TGATTCTGTGTGATGG	Astrocytes
TGATTTCCACTGATTG	MOLs
TGATTTCCAGTAACCT	Macrophages
TGATTTCCATACCGTA	MOLs
TGCACGGAGACGTCGA	InhibNeuron
TGCACGGAGCCGGATA	Astrocytes
TGCACGGGTCCACATA	ExciteL4
TGCACGGTCGATTGAC	OPCs
TGCAGATAGAGCAACC	Microglia
TGCAGATCATGGACAG	ExciteL6
TGCAGGCAGACCGTTT	ExciteL6
TGCAGGCCAATTGCCA	ExciteL6
TGCAGGCGTCTTGAGT	ExciteL4
TGCAGGCTCAAGTGGG	ExciteL5
TGCAGGCTCCTTCGAC	Microglia
TGCAGGCTCTCGCCTA	MOLs
TGCAGTATCACATACG	MOLs
TGCAGTATCTGAGGTT	Pericytes
TGCATCCAGATAACAC	ExciteL4
TGCATCCAGCACCTGC	ExciteL4
TGCATCCCACAACATC	InhibNeuron
TGCATCCGTCGTACAT	Astrocytes
TGCATCCGTTCCAAAC	ExciteL23
TGCATGAAGATGACCG	MOLs
TGCATGAAGCGCTGCT	Microglia
TGCATGAAGGAGTCTG	Microglia
TGCATGACAGGACGAT	ExciteL4
TGCATGATCCGCTAGG	ExciteL4
TGCCGAGCATATGCGT	MOLs
TGCCGAGGTGTCTAAC	ExciteL5
TGCGACGCACAACGCC	Pericytes
TGCGACGCATAAGCGG	ExciteL4
TGCGACGTCAGACTGT	ExciteL4
TGCGACGTCCGTCCTA	OPCs
TGCGATAAGAAACCAT	ExciteL4
TGCGATACAATCTGCA	COPs
TGCGATACACGACGTC	ExciteL4
TGCGATACACTAGAGG	ExciteL6
TGCGATACACTGAATC	ExciteL4
TGCGATACATCATTGG	MOLs
TGCGATATCAAAGGAT	MOLs
TGCGGCAAGAAGCTCG	MOLs
TGCGGCAAGCATCAAA	OPCs
TGCGGCACAATCGCGC	InhibNeuron
TGCGGCAGTACACGCC	ExciteL4
TGCGGCATCTCGGTAA	ExciteL6
TGCGGCATCTTTCCGG	Microglia
TGCGGGTCAGGAGACT	ExciteL6
TGCTCCATCCACGGAC	Microglia
TGCTCGTCAAGGCTTT	Microglia
TGCTCGTCACTGGATT	Microglia
TGCTCGTGTTTCTTAC	MOLs
TGCTGAAAGTTCATGC	InhibNeuron
TGCTGAATCAATCCGA	Astrocytes
TGCTGAATCCAGTGCG	ExciteL4
TGCTTCGAGTATAGGT	ExciteL4
TGCTTCGCAAAGGTTA	ExciteL23
TGCTTCGCAGACACAG	ExciteL6
TGCTTCGGTGCTCGTG	MOLs
TGCTTGCAGGCCTGAA	ExciteL6
TGCTTGCCAAGAATGT	ExciteNP
TGCTTGCCAAGCACAG	ExciteL4
TGCTTGCCACAGCTGC	ExciteL4
TGCTTGCCAGTGCCTG	COPs
TGGAACTAGAATCTAG	MOLs
TGGAACTCAGGTTACT	MFOLs
TGGAGAGAGTACAGCG	Microglia
TGGAGAGAGTATGGAT	MOLs
TGGAGAGGTTAAGTCC	Endo
TGGAGAGGTTGCATTG	ExciteL4
TGGAGGAAGACCTCCG	ExciteL4
TGGAGGAGTCAGTTTG	ExciteL4
TGGATCACAAGAGTAT	ExciteL4
TGGATCACAATTCGTG	ExciteL4
TGGATCACACAAGCTT	Astrocytes
TGGATCACATGCGGTC	MOLs
TGGATCAGTACTCCGG	ExciteL4
TGGATCAGTCAGTCCG	ExciteL5
TGGATCATCCATTCGC	ExciteL6
TGGATGTAGCATTTCG	Astrocytes
TGGATGTAGGACACTG	ExciteL6
TGGATGTCAGACCAAG	MOLs
TGGATGTCATCGAGCC	MOLs
TGGATGTTCACCTTGC	ExciteL4
TGGATGTTCCTGCCAT	Microglia
TGGCGTGGTCAAGCCC	ExciteL4
TGGCGTGGTCGAATGG	Astrocytes
TGGCGTGGTGCTATTG	OPCs
TGGCGTGTCGATTGGT	MOLs
TGGGAAGAGTGGACGT	MOLs
TGGGAAGCAACAGCCC	ExciteL4
TGGGAAGGTCACTACA	Endo
TGGGAAGGTTTGAACC	ExciteL4
TGGGAAGTCCAGCCTT	MOLs
TGGGAAGTCGGAATGG	ExciteL4
TGGGAGAAGGCTAACG	ExciteL4
TGGGAGATCCACATAG	ExciteL4
TGGGATTAGTTTGTCG	ExciteNP
TGGGATTTCAACGTGT	Astrocytes
TGGGCGTAGGCGTCCT	ExciteL4
TGGGCGTCAACATACC	ExciteL6
TGGGCGTCAACATCGT	ExciteL5
TGGGCGTCACCAGTAT	Pericytes
TGGGCGTTCCGATCGG	Microglia
TGGGCTGGTGTGAGCA	Ependymal
TGGGCTGTCTTCGGAA	MOLs
TGGGTTAAGATCGGTG	MOLs
TGGGTTAAGCTTCATG	ExciteL6
TGGGTTACAAGCGAGT	InhibNeuron
TGGGTTAGTGCGTGCT	MOLs
TGGGTTAGTGGACTGA	Pericytes
TGGTAGTAGCCTTGAT	Microglia
TGGTAGTCAGGCACAA	OPCs
TGGTAGTGTCGTTTCC	ExciteNP
TGGTAGTTCACTCGAA	InhibNeuron
TGGTAGTTCATCTATC	ExciteL6
TGGTGATAGTCATACC	MFOLs
TGGTGATAGTTGCATC	ExciteL6
TGGTGATTCCGATAGT	ExciteL23
TGGTTAGAGGCGTTAG	Astrocytes
TGGTTAGGTGCGCTCA	ExciteL23
TGTAACGAGATTGGGC	Astrocytes
TGTAACGCAGATTAAG	ExciteL6
TGTAACGTCCACAAGT	ExciteL6
TGTAACGTCCATTTAC	ExciteL4
TGTAAGCCACTGCTTC	MOLs
TGTAAGCCATGCGTGC	Microglia
TGTAAGCGTTCTCGTC	MOLs
TGTAAGCTCCCATAAG	MOLs
TGTACAGAGATTCGCT	MOLs
TGTACAGAGCAAGTGC	ExciteL6
TGTACAGAGTGCCTCG	ExciteL4
TGTACAGGTCCACGCA	MOLs
TGTACAGGTTAGGAGC	MOLs
TGTACAGTCGAGATAA	ExciteL4
TGTACAGTCGGTAAGG	MOLs
TGTAGACGTTACACAC	ExciteL6
TGTAGACTCGGTGTTA	MOLs
TGTCAGACAACGTATC	ExciteL4
TGTCAGACAAGTAGTA	Pericytes
TGTCCACAGCAAGTCG	ExciteL4
TGTCCACAGGTTCCAT	ExciteL6
TGTCCACCACAACGCC	ExciteL6
TGTCCACCAGTCAACT	MOLs
TGTCCACGTCATGACT	ExciteL4
TGTCCACGTTAAGCAA	OPCs
TGTCCACTCCTCAGAA	ExciteL4
TGTCCCAAGAGCATAT	OPCs
TGTCCCAGTCTCAGAT	ExciteL6
TGTCCCATCGTTCCTG	ExciteL4
TGTCCTGGTGATGGCA	Microglia
TGTCCTGTCAAGCTGT	ExciteL4
TGTCCTGTCAAGGCTT	ExciteL5
TGTCCTGTCTTCGGAA	Microglia
TGTGAGTAGAGGTCAC	Microglia
TGTGAGTAGCGATGAC	Microglia
TGTGAGTGTGTTCAGT	Astrocytes
TGTGAGTTCAAGCCAT	ExciteL5
TGTGAGTTCACTCCGT	MOLs
TGTGAGTTCCAGCAAT	ExciteL4
TGTGATGAGATCACCT	ExciteNP
TGTGATGAGCCACCGT	ExciteL5
TGTGATGAGGAAGTCC	ExciteL6
TGTGATGGTATGACAA	ExciteL4
TGTGATGGTGTTGATC	ExciteL6
TGTGATGGTTAGGACG	ExciteL5
TGTGATGTCTTGAGCA	Microglia
TGTGCGGAGACCTTTG	MOLs
TGTGCGGAGCATATGA	ExciteL4
TGTGCGGAGCGATGGT	ExciteL6
TGTGCGGGTAATGATG	MOLs
TGTGCGGGTCTTGGTA	ExciteL6
TGTGCGGGTGCGGCTT	ExciteL6
TGTGCGGGTTCCGCAG	ExciteL4
TGTGCGGTCCGCACGA	OPCs
TGTGGCGAGTACCGGA	MOLs
TGTGGCGGTTGAGGAC	ExciteL4
TGTGGCGTCGCCACTT	ExciteNP
TGTGGCGTCGGCCAAC	OPCs
TGTTACTAGACAGCGT	NIPCs
TGTTACTAGTATAGGT	Microglia
TGTTACTCACTGTCGG	ExciteL4
TGTTACTCATATGCGT	ExciteL6
TGTTACTTCCAGCACG	ExciteL6
TGTTCATAGGGTGAGG	MOLs
TGTTCATAGTCGAATA	ExciteL6
TGTTCATGTGAGCAGT	ExciteL6
TGTTCATGTTTCGACA	ExciteL6
TGTTCATTCTTTGCTA	ExciteL4
TGTTCCGAGCGCTGAA	ExciteL6
TGTTCCGGTACAAGCG	ExciteL6
TGTTCCGTCAGGGTAG	InhibNeuron
TGTTCCGTCATCGGGC	ExciteL6
TGTTCTAAGAGCCGAT	ExciteNP
TGTTCTAAGAGTGTGC	Microglia
TGTTCTAAGGCTCTAT	OPCs
TGTTCTAAGTTGAAAC	Microglia
TGTTCTACAGATCCAT	MOLs
TGTTCTAGTGGTCTGC	MOLs
TGTTCTATCAGCCTCT	ExciteL6
TGTTCTATCCCGAGGT	ExciteL4
TGTTCTATCGGCTCTT	ExciteL6
TGTTCTATCGGCTTGG	ExciteL6
TGTTGAGCAATCGCCG	ExciteL6
TGTTGAGCACCATATG	MOLs
TGTTGAGGTTCAAGTC	Pericytes
TGTTGAGTCTAAACGC	OPCs
TGTTGAGTCTTAATCC	ExciteL4
TGTTGGAAGCGGCTCT	ExciteL6
TGTTGGACATTAGGCT	InhibNeuron
TGTTGGAGTGGATCGA	ExciteL5
TGTTGGATCATTGCGA	Microglia
TGTTGGATCATTTGGG	ExciteL23
TGTTGGATCCTCAGGG	MOLs
TGTTTGTAGATTCGAA	MOLs
TGTTTGTAGTATGCAA	MOLs
TGTTTGTCAAGTACCT	MOLs
TTAATCCAGTGAGTGC	Astrocytes
TTAATCCCAACTGAAA	ExciteL6
TTAATCCGTCTATGAC	MOLs
TTACAGGAGCTCGGCT	ExciteL6
TTACAGGAGGCTCAAG	OPCs
TTACAGGCAAGCAGGT	MOLs
TTACAGGGTCATGGCC	MOLs
TTACAGGGTGTTCCTC	ExciteL5
TTACAGGGTTGTAGCT	ExciteL4
TTACCATGTGCAATAA	OPCs
TTACCGCAGCTCAGAG	OPCs
TTACCGCAGGCCACTC	ExciteL6
TTACCGCAGTCGCGAA	Pericytes
TTACCGCCAGTTAGAA	Microglia
TTACCGCGTTGGCCTG	OPCs
TTACGCCAGCCTCAAT	Pericytes
TTACGCCGTCGGATTT	ExciteL5
TTACGTTCAAATCGTC	ExciteL6
TTACGTTCAGCAGTAG	MOLs
TTACGTTGTTCTAAGC	ExciteL6
TTACGTTTCTTCTCAA	MOLs
TTACTGTGTATCGTTG	ExciteL6
TTACTGTGTCGGCACT	MOLs
TTAGGCAAGCTTCGTA	OPCs
TTAGGCAAGTCTAGAA	ExciteL6
TTAGGGTAGACCAGCA	ExciteL6
TTAGGGTCAATAGTCC	InhibNeuron
TTAGGGTGTAACAGTA	ExciteL5
TTAGGGTGTGACGTCC	MFOLs
TTAGGGTGTGCACAAG	Microglia
TTAGGGTGTGTGTCGC	MOLs
TTAGGGTGTTAGGGTG	ExciteL5
TTAGGGTGTTCCTAGA	MOLs
TTAGTCTAGCGAGGAG	ExciteL6
TTAGTCTGTAGCGCTC	OPCs
TTAGTCTTCCTCACTG	ExciteL23
TTATTGCAGCCTTGAT	MOLs
TTATTGCCAAAGTATG	ExciteL6
TTATTGCCACAACGAG	ExciteL6
TTATTGCCATAGCACT	Astrocytes
TTATTGCGTTGCTCAA	ExciteL4
TTATTGCGTTTCTTAC	MOLs
TTCAATCAGGCATTTC	ExciteNP
TTCAATCGTCCGACGT	Microglia
TTCAATCTCGAGCCTG	Microglia
TTCACCGAGGTCTTTG	MOLs
TTCACCGCACATGAAA	COPs
TTCACCGGTTACGATC	ExciteL6
TTCACCGTCCATTGTT	ExciteL4
TTCACGCAGCGACTAG	MOLs
TTCACGCAGCTCCCTT	MOLs
TTCACGCGTGAGGCAT	Macrophages
TTCACGCGTGTCTAAC	ExciteL4
TTCACGCGTTCCTAGA	Microglia
TTCAGGAAGACTCAAA	OPCs
TTCAGGAAGATGAAGG	ExciteL23
TTCAGGATCATGCTAG	ExciteL4
TTCATGTAGCAAATGT	ExciteL5
TTCATGTGTATCCCAA	ExciteL4
TTCATGTTCAGCTGTA	ExciteL4
TTCATGTTCCGTGGCA	MOLs
TTCATGTTCCGTGGTG	ExciteL4
TTCATGTTCGTTTACT	MOLs
TTCATTGAGCCTCATA	Microglia
TTCATTGAGGCACTAG	ExciteL6
TTCATTGGTCTGATCA	MOLs
TTCATTGGTGTTGATC	OPCs
TTCATTGGTTAATCGC	ExciteL6
TTCCAATAGAGCTGAC	ExciteL6
TTCCAATCAGCTTTGA	MOLs
TTCCACGAGCATACTC	ExciteL4
TTCCACGCATGACCCG	MOLs
TTCCACGGTCCATAGT	ExciteL5
TTCCACGTCCTGATAG	ExciteNP
TTCCGGTAGGGTGAAA	ExciteL6
TTCCGGTAGTCATACC	NIPCs
TTCCGGTCATAAGCAA	ExciteL6
TTCCGGTGTAGTGGCA	ExciteL4
TTCCGGTTCCTATTTG	ExciteL5
TTCCGTGAGTTCCATG	MOLs
TTCCGTGGTCATCACA	Microglia
TTCCGTGGTGCAATGG	ExciteL4
TTCCGTGGTGCATGAG	ExciteL5
TTCCTAAAGCGGGTAT	ExciteL6
TTCCTAAGTCGAGATG	MOLs
TTCCTAAGTTCGCGTG	MOLs
TTCCTAAGTTCTCTCG	MOLs
TTCCTAATCGCGTGAC	ExciteL6
TTCCTCTAGTGCGTCC	InhibNeuron
TTCCTCTCAAATACAG	MOLs
TTCCTCTCATAGAATG	MOLs
TTCCTCTGTCGTATGT	Microglia
TTCCTTCAGAAACCAT	MOLs
TTCCTTCCAGGACAGT	ExciteL6
TTCGATTAGCCTTTGA	OPCs
TTCGATTCAGCACAGA	ExciteL6
TTCGATTGTGATGTAA	ExciteL6
TTCGCTGAGAAGAACG	ExciteL4
TTCGCTGCACAATGAA	InhibNeuron
TTCGCTGGTCCGACGT	ExciteL4
TTCGGTCAGTGCCCGT	ExciteL4
TTCGGTCGTCAGACGA	ExciteL6
TTCTAACCAAATCGGG	MFOLs
TTCTAACGTCAGATTC	MOLs
TTCTAACGTGGTTTAC	ExciteL5
TTCTAGTAGCAGCGAT	ExciteL5
TTCTAGTAGCTTTGTG	ExciteL6
TTCTAGTCAACCCTAA	MOLs
TTCTAGTCAGTAACGG	MOLs
TTCTAGTTCCCGTTGT	ExciteL6
TTCTAGTTCGAACTCA	ExciteL4
TTCTCTCAGATAGCAT	ExciteL5
TTCTCTCAGCTAAGTA	ExciteNP
TTCTCTCCAATAACCC	MOLs
TTCTCTCCACCGTCTT	ExciteL4
TTCTGTAAGTCCCGAC	ExciteL5
TTCTGTACACCAGTAT	MOLs
TTCTGTATCATTGCTT	ExciteL4
TTCTTCCAGGGCAGGA	MOLs
TTCTTCCCACACGGAA	ExciteL6
TTCTTCCCACCCTAGG	Microglia
TTCTTCCGTTTGGGAG	MOLs
TTCTTCCTCTCCCAAC	MFOLs
TTCTTGAGTTGTGCAT	ExciteL6
TTCTTGATCCGTCCTA	ExciteL4
TTCTTGATCGAGTTGT	ExciteL6
TTCTTGATCGCAGTCG	MOLs
TTGAACGAGAGCCATG	MOLs
TTGAACGAGAGCTTTC	ExciteL4
TTGAACGCATAATGAG	InhibNeuron
TTGAACGCATCTGCGG	OPCs
TTGAACGGTACCTGTA	ExciteL6
TTGAACGGTCGTCAGC	MFOLs
TTGAACGGTTTACGTG	ExciteL4
TTGAACGTCCATCGTC	Astrocytes
TTGAACGTCGAAGCAG	ExciteL4
TTGACCCCAGTAGGAC	ExciteL6
TTGACCCGTTGACTGT	MOLs
TTGAGTGAGTCTTGGT	InhibNeuron
TTGAGTGGTATGGAAT	Astrocytes
TTGAGTGGTGGATGAC	ExciteL4
TTGAGTGGTGGCTGAA	ExciteL4
TTGATGGAGCAGTAAT	ExciteL6
TTGATGGAGCCTTTCC	Microglia
TTGATGGCACGCGCAT	Microglia
TTGATGGGTCACGTGC	ExciteL6
TTGATGGGTGAGAGGG	ExciteL6
TTGATGGTCATCCTGC	ExciteL6
TTGATGGTCGGCTTCT	MOLs
TTGCATTAGCCGGATA	MOLs
TTGCATTTCATCGTAG	Microglia
TTGCATTTCGACTCCT	MOLs
TTGCCTGAGTCACGCC	InhibNeuron
TTGCCTGGTGAGACCA	ExciteL6
TTGCGTCAGTACAGAT	ExciteL6
TTGCTGCAGCGGCTCT	ExciteL4
TTGCTGCAGTGGGAAA	Microglia
TTGCTGCCATAATGCC	Astrocytes
TTGCTGCGTTCTCTCG	OPCs
TTGCTGCTCATCGACA	ExciteL4
TTGGATGAGAGTATAC	ExciteNP
TTGGATGAGGATACCG	ExciteL6
TTGGATGAGTATAACG	Microglia
TTGGATGCAGAATCGG	MOLs
TTGGATGCAGCCTACG	MOLs
TTGGATGCATAAGATG	MOLs
TTGGATGGTACGCGTC	MOLs
TTGGATGGTCATACCA	ExciteL6
TTGGATGGTCCGACGT	ExciteL6
TTGGATGGTCGTTCAA	ExciteL6
TTGGATGGTGTGGTCC	Pericytes
TTGGATGTCAGTCATG	ExciteL4
TTGGATGTCCAAGCAT	ExciteL6
TTGGATGTCGGACCAC	ExciteL6
TTGGGATGTGCAGATG	MOLs
TTGGGCGAGGAAAGTG	Microglia
TTGGGCGTCACTTGTT	MOLs
TTGGGCGTCGCTACAA	MOLs
TTGGGCGTCGGCGATC	InhibNeuron
TTGGGTAAGCGGGTAT	Astrocytes
TTGGGTACACGTCGGT	Microglia
TTGGGTACAGATGCGA	MOLs
TTGGGTACAGCTACCG	ExciteL4
TTGGGTATCACAAGGG	MOLs
TTGGGTATCCAGTACA	ExciteL4
TTGGGTATCGGTAAGG	ExciteL4
TTGGTTTAGAGTCAGC	ExciteL5
TTGGTTTAGTAGGTTA	ExciteL4
TTGGTTTCACAACGTT	ExciteL5
TTGTGTTAGTATCTGC	ExciteL4
TTGTGTTCAGTCCGTG	Microglia
TTGTGTTGTAGCTGCC	Microglia
TTGTGTTTCAAGAAAC	MOLs
TTGTGTTTCTATACGG	ExciteL6
TTGTTCACAGATTTCG	MOLs
TTGTTCATCGATTGGT	Microglia
TTGTTGTCACATAGCT	ExciteL23
TTGTTGTCACGACGTC	ExciteL4
TTGTTGTGTCGTCGGT	ExciteL6
TTGTTGTGTGGATGAC	ExciteL6
TTGTTGTTCATAGGCT	ExciteL5
TTGTTTGAGACTCTAC	ExciteL6
TTTACCAGTTATCTTC	InhibNeuron
TTTACCATCGAGCCTG	ExciteNP
TTTACCATCTCACTCG	ExciteL6
TTTACGTAGGGCCAAT	MOLs
TTTACGTAGTACTGTC	ExciteL6
TTTACGTCAGCTGGTC	MOLs
TTTACTGCACATTCGA	ExciteL5
TTTACTGGTCGCACAC	ExciteL6
TTTACTGTCTTAGCTT	MOLs
TTTACTGTCTTAGTTC	ExciteL4
TTTAGTCTCACATTGG	ExciteL6
TTTAGTCTCTGCTAGA	OPCs
TTTATGCCAATTGCCA	MOLs
TTTATGCTCGCCCAGA	ExciteL4
TTTATGCTCGGCATAT	ExciteL5
TTTATGCTCTGTCTCG	ExciteL4
TTTCACAAGCGATGGT	Endo
TTTCACAGTCTCGACG	MOLs
TTTCACAGTGTAGGAC	Macrophages
TTTCAGTCAAGCGAGT	MOLs
TTTCAGTCACTGCTTC	ExciteL6
TTTCAGTTCATTCATC	ExciteL5
TTTCATGAGACATAAC	OPCs
TTTCATGAGCACTCCG	ExciteL6
TTTCATGAGCATATGA	ExciteL4
TTTCATGAGTCACTCA	ExciteL4
TTTCATGCAAGCTGTT	ExciteL5
TTTCATGCATGATGCT	ExciteL6
TTTCATGGTAATTGGA	Microglia
TTTCATGGTATTGCCA	ExciteL5
TTTCATGGTCCTCATC	ExciteL4
TTTCATGTCCATTTAC	ExciteL4
TTTCCTCCAGCGTACC	ExciteNP
TTTCCTCGTCACTTAG	ExciteL6
TTTCCTCGTCGAGTGA	ExciteL4
TTTCGATAGACGCCCT	InhibNeuron
TTTCGATAGTCCGCCA	Microglia
TTTCGATGTCAGGAGT	MOLs
TTTCGATTCGCCCAGA	ExciteL4
TTTGACTAGCAAATGT	Astrocytes
TTTGACTGTAGCTCGC	MOLs
TTTGACTTCATTGTGG	MOLs
TTTGATCCAGGACTTT	Macrophages
TTTGATCGTGGAGGTT	ExciteL4
TTTGATCTCCAATCCC	MOLs
TTTGATCTCTGCGTCT	ExciteL4
TTTGATCTCTGCTCTG	ExciteL6
TTTGGAGTCAACGAGG	MOLs
TTTGGTTCAAATCGTC	ExciteL23
TTTGGTTCACATGTTG	NIPCs
TTTGGTTCATTAGGAA	ExciteL5
TTTGGTTGTATGCTAC	Astrocytes
TTTGGTTTCACCACAA	Microglia
TTTGGTTTCATCAGTG	Pericytes
TTTGGTTTCCACGGGT	ExciteL6
TTTGTTGAGATACTGA	ExciteL6
TTTGTTGCAGCAGTGA	Astrocytes
TTTGTTGCATGAAAGT	ExciteL6
TTTGTTGGTACCATAC	InhibNeuron
TTTGTTGGTTACCCAA	MOLs
