AAACCCAAGATTAGCA	COPs
AAACCCAAGGTTTGAA	Astrocytes
AAACCCACAAGGTCTT	ExciteL5
AAACCCACAGACACCC	ExciteL6
AAACCCACAGGGTCTC	MOLs
AAACCCAGTCTCTCTG	OPCs
AAACCCAGTTGCTAGT	Microglia
AAACCCATCCAGTGTA	Microglia
AAACCCATCTGCCTGT	ExciteL23
AAACGAAAGAGAGGTA	ExciteL23
AAACGAAAGGCGCTCT	Pericytes
AAACGAAAGGTGATCG	ExciteL6
AAACGAACACCCAACG	ExciteL4
AAACGAACATCGGAGA	MOLs
AAACGAAGTACAACGG	ExciteL6
AAACGAAGTGACGTCC	MOLs
AAACGAATCAGGAAGC	ExciteL23
AAACGAATCCCTATTA	Astrocytes
AAACGAATCTACTTCA	InhibNeuron
AAACGAATCTGCACCT	ExciteL23
AAACGCTAGGTCATCT	ExciteL6
AAACGCTCAAAGCGTG	Astrocytes
AAACGCTCAATGTCTG	OPCs
AAACGCTCAGCCGTCA	MOLs
AAACGCTCATGGCCAC	Microglia
AAACGCTGTCTTTCAT	InhibNeuron
AAACGCTTCAGCACCG	InhibNeuron
AAACGCTTCGTCTACC	ExciteL4
AAAGAACAGGGAGTGG	MOLs
AAAGAACAGTAAACTG	ExciteL6
AAAGAACCAGGCCCTA	ExciteL4
AAAGAACGTTACCTTT	InhibNeuron
AAAGAACTCCGCTGTT	Microglia
AAAGGATAGTAACAGT	InhibNeuron
AAAGGATCAACCTATG	OPCs
AAAGGATGTGGATCAG	Astrocytes
AAAGGATTCCCGAACG	OPCs
AAAGGATTCTATGCCC	ExciteL4
AAAGGGCAGTACTGGG	ExciteL6
AAAGGGCAGTTCATGC	Microglia
AAAGGGCCACGGTGCT	Macrophages
AAAGGGCCAGTCTTCC	ExciteL6
AAAGGGCCAGTTGGTT	OPCs
AAAGGGCCATTCACAG	Macrophages
AAAGGGCTCACAAGAA	ExciteL4
AAAGGGCTCACGAACT	OPCs
AAAGGGCTCGGCATCG	Astrocytes
AAAGGGCTCTACTGCC	ExciteL4
AAAGGGCTCTGCCTGT	ExciteL4
AAAGGTAAGTGAGGCT	ExciteL23
AAAGGTACAACCAATC	MOLs
AAAGGTACATATTCGG	OPCs
AAAGGTAGTTCCAAAC	Astrocytes
AAAGGTAGTTCCCAAA	ExciteL23
AAAGGTAGTTCTCACC	ExciteL6
AAAGGTATCAGCTGTA	OPCs
AAAGGTATCCGCATAA	Astrocytes
AAAGGTATCCTCACCA	MOLs
AAAGGTATCGCAGTCG	MOLs
AAAGGTATCGCTGCGA	Astrocytes
AAAGGTATCGTGGTAT	InhibNeuron
AAAGTCCAGACCTCCG	Endo
AAAGTCCAGACTTCAC	ExciteL6
AAAGTCCAGGTGCCTC	ExciteL4
AAAGTCCCAAATTGCC	ExciteL4
AAAGTCCCAACGACTT	COPs
AAAGTCCTCCTCTCTT	MOLs
AAAGTGAAGCAATTCC	ExciteL4
AAAGTGACAATTCTTC	ExciteL6
AAAGTGACACTATGTG	COPs
AAAGTGAGTGCCCTTT	MFOLs
AAAGTGAGTTGGGCCT	Pericytes
AAATGGAAGGAAGTCC	OPCs
AAATGGAAGGTGCAGT	Microglia
AAATGGAAGGTTATAG	InhibNeuron
AAATGGACAGTATGAA	Microglia
AAATGGAGTAATGCTC	Endo
AAATGGAGTGACTCGC	OPCs
AAATGGATCCGCAGTG	MOLs
AAATGGATCTGCTTAT	Astrocytes
AACAAAGAGATAGGGA	Microglia
AACAAAGCACATTCTT	ExciteL4
AACAAAGGTACTCGAT	ExciteL23
AACAAAGGTTGGGATG	NIPCs
AACAAAGTCCTGCCAT	ExciteL6
AACAAAGTCGGAGATG	ExciteNP
AACAACCCAACGACTT	MOLs
AACAACCGTGATAGTA	Astrocytes
AACAACCTCACCGCTT	ExciteL6
AACAACCTCATGGATC	ExciteL6
AACAAGAAGGCACAAC	Astrocytes
AACAAGACAACGGTAG	Astrocytes
AACAAGACACCACATA	Microglia
AACAAGACACTACCCT	Microglia
AACAAGACATCTTTCA	Microglia
AACAAGAGTGGAAATT	NIPCs
AACAAGATCAGACAAA	ExciteL6
AACACACAGAGTTGAT	Microglia
AACACACAGCGAATGC	ExciteL6
AACACACGTAGTACGG	Microglia
AACACACGTCGCACGT	OPCs
AACACACGTTGGGATG	OPCs
AACACACGTTGGGTTT	ExciteL6
AACACACTCTCAACCC	ExciteL4
AACAGGGAGATAGCTA	Microglia
AACAGGGAGTGCCTCG	ExciteL23
AACAGGGCAATGGCCC	ExciteL4
AACAGGGCACACCAGC	Astrocytes
AACAGGGCACCGTCGA	OPCs
AACAGGGGTGACTATC	Microglia
AACAGGGGTTGAGAGC	ExciteL23
AACAGGGTCTGCTGAA	Microglia
AACCAACAGTAATTGG	OPCs
AACCAACTCACCCTCA	Microglia
AACCAACTCGTGCACG	COPs
AACCAACTCTGAGGTT	ExciteL4
AACCACAAGATAGCTA	MOLs
AACCACAAGGCTATCT	Macrophages
AACCACACAAGTGATA	Microglia
AACCACAGTGCTTCAA	Microglia
AACCACAGTTGACTGT	ExciteL6
AACCACATCTGATGGT	OPCs
AACCATGAGCCACTCG	MOLs
AACCATGGTTCGGTAT	Microglia
AACCATGTCATGCTAG	InhibNeuron
AACCCAAAGACCATAA	Astrocytes
AACCCAAAGCAACAGC	MOLs
AACCCAACACAAATCC	ExciteL4
AACCCAACAGTGTGGA	MOLs
AACCCAAGTATCGGTT	Microglia
AACCCAAGTCTGGTTA	OPCs
AACCTGACAACAAGAT	Microglia
AACCTGACAATGTCAC	Microglia
AACCTGACAGGGACTA	OPCs
AACCTGAGTACGATGG	OPCs
AACCTGAGTACTTGTG	ExciteNP
AACCTGAGTTTACCTT	ExciteL5
AACCTGATCACGGGAA	ExciteL23
AACCTGATCACTCCGT	Microglia
AACCTTTAGCCTCATA	Microglia
AACCTTTCACGTGAGA	COPs
AACCTTTGTAGCGTAG	ExciteL4
AACCTTTGTCGTCATA	Microglia
AACCTTTGTGTTACTG	Microglia
AACGAAAAGGCTCAAG	ExciteL6
AACGAAAAGTGATAGT	Astrocytes
AACGAAACAAGCACCC	OPCs
AACGAAACAGACATCT	Microglia
AACGAAACAGGACTTT	ExciteL6
AACGAAACATCATCCC	ExciteL6
AACGAAAGTCGACTGC	InhibNeuron
AACGAAAGTCGTCGGT	Astrocytes
AACGAAAGTTCGTGCG	MOLs
AACGGGAAGCGTATGG	MOLs
AACGGGAAGCTTCGTA	ExciteL4
AACGGGACACGTAACT	Microglia
AACGGGACATAGAAAC	ExciteNP
AACGGGAGTACGAAAT	OPCs
AACGGGAGTGGACAGT	Astrocytes
AACGGGAGTTTAGACC	Microglia
AACGGGATCGAGAAGC	Microglia
AACGTCAAGTAGGTTA	ExciteL4
AACGTCACAATTGTGC	OPCs
AACGTCACACCTCTGT	Endo
AACGTCACACGGTGAA	Endo
AACGTCACACTTCAGA	OPCs
AACGTCACAGCACACC	ExciteL6
AACGTCACAGTTGTCA	ExciteL5
AACGTCAGTATTTCCT	MOLs
AACGTCAGTCCCGCAA	ExciteL4
AACGTCAGTCCTTTGC	ExciteL4
AACGTCAGTTCCGCTT	MOLs
AACTTCTAGAGCTGAC	ExciteL6
AACTTCTCAAGTATCC	Astrocytes
AACTTCTGTTGCATGT	ExciteNP
AACTTCTTCCTAACAG	ExciteL6
AACTTCTTCGACCATA	Astrocytes
AAGAACACAAGAGATT	Microglia
AAGAACATCATGGTAC	Astrocytes
AAGAACATCGCCAGAC	ExciteL4
AAGACAAAGATGTTCC	MOLs
AAGACAACACGCTGAC	ExciteL6
AAGACAACATGAGAAT	NIPCs
AAGACAAGTCTTAGTG	ExciteL23
AAGACAAGTGAATGAT	ExciteL4
AAGACAATCGGAACTT	ExciteL6
AAGACAATCTGGTGGC	Microglia
AAGACTCAGGCTTAAA	OPCs
AAGACTCCAGAGAATT	MOLs
AAGACTCCAGTAGGAC	Microglia
AAGACTCCATTGGGAG	Microglia
AAGACTCGTACGATGG	Microglia
AAGACTCGTGACTGTT	ExciteL23
AAGACTCGTGTCCTAA	Astrocytes
AAGACTCTCGAACTCA	Astrocytes
AAGACTCTCGAGTTGT	OPCs
AAGACTCTCGTACACA	ExciteL6
AAGATAGCAAGGTCGA	Microglia
AAGATAGCAAGTGGTG	OPCs
AAGATAGCACAGCATT	Microglia
AAGATAGCAGCCCAGT	Microglia
AAGATAGCATTAAGCC	Astrocytes
AAGATAGGTGTAAATG	Microglia
AAGATAGGTTCTTGCC	ExciteL5
AAGATAGGTTGCGTAT	Microglia
AAGATAGTCCATAGAC	Astrocytes
AAGATAGTCGGTATGT	ExciteL4
AAGCATCAGCTCTTCC	ExciteL4
AAGCATCCACGCTATA	Microglia
AAGCATCCAGGAGACT	ExciteL5
AAGCATCTCCTTCAGC	MOLs
AAGCATCTCGGCCTTT	Microglia
AAGCCATAGCCTCTGG	Endo
AAGCCATCATAAGCGG	ExciteL6
AAGCCATCATCTGGGC	MOLs
AAGCCATGTCGTGATT	ExciteL4
AAGCCATGTCGTTATG	ExciteL4
AAGCCATGTCTGATAC	Microglia
AAGCCATGTGAAAGTT	Microglia
AAGCCATGTTCTCAGA	ExciteL23
AAGCCATTCCGGGACT	COPs
AAGCCATTCGACCACG	OPCs
AAGCGAGAGCGAGTCA	ExciteL6
AAGCGAGCACAACGTT	Astrocytes
AAGCGAGCAGCTATTG	MOLs
AAGCGTTAGAAGAACG	MOLs
AAGCGTTAGTGGCCTC	ExciteL6
AAGCGTTGTCGGATTT	ExciteL4
AAGCGTTTCGGATAAA	ExciteL23
AAGGAATAGCACACCC	ExciteL6
AAGGAATAGTCAAGCG	ExciteL6
AAGGAATGTGACACGA	OPCs
AAGGAATGTGCCCACA	ExciteL4
AAGGAATGTGGACCAA	Microglia
AAGGAATTCCTTCAGC	ExciteL4
AAGGTAAAGAAGTATC	ExciteL4
AAGGTAAAGCGTGCCT	ExciteL4
AAGGTAAAGGAAAGGT	ExciteL4
AAGGTAAAGGTGCAGT	MOLs
AAGGTAACAAATCGGG	MOLs
AAGGTAACACCTATCC	ExciteL6
AAGGTAACACCTGATA	ExciteL23
AAGGTAATCGGAGTGA	ExciteL4
AAGTACCCAAGGGCAT	Astrocytes
AAGTACCCAGACCAGA	Microglia
AAGTACCCATCCAACA	MOLs
AAGTACCCATTAGGAA	ExciteL6
AAGTACCGTCACATTG	Microglia
AAGTACCGTCGTGGTC	ExciteL5
AAGTACCGTTGCATGT	Microglia
AAGTACCTCAAGGACG	ExciteL6
AAGTACCTCAATCCAG	Microglia
AAGTCGTAGAGAATCT	OPCs
AAGTCGTAGATGCTAA	ExciteL6
AAGTCGTAGGGAGGGT	OPCs
AAGTCGTCATACAGAA	ExciteL23
AAGTCGTCATAGATGA	ExciteL6
AAGTCGTGTGCAATAA	NIPCs
AAGTCGTGTGTGTTTG	ExciteL6
AAGTCGTTCTGCTGAA	ExciteL5
AAGTGAAAGTGCAGCA	ExciteL4
AAGTGAATCGTGGTAT	OPCs
AAGTTCGAGAATTGCA	Astrocytes
AAGTTCGCAATCTAGC	ExciteL6
AAGTTCGCAATTTCTC	ExciteL4
AAGTTCGCAGTCGAGA	Microglia
AAGTTCGGTAACGTTC	Astrocytes
AAGTTCGGTCAGATTC	ExciteL6
AAGTTCGGTTTGCCGG	Astrocytes
AAGTTCGTCCCAGGCA	OPCs
AAGTTCGTCGTTCCTG	OPCs
AAGTTCGTCTATTCGT	ExciteL4
AATAGAGAGTTGGAAT	ExciteL4
AATAGAGCAATACGCT	Astrocytes
AATAGAGGTTTCGTGA	Astrocytes
AATAGAGTCAGCAGAG	ExciteL23
AATCACGAGAGACAAG	COPs
AATCACGAGTGCAGCA	ExciteL4
AATCACGCAAACTGCT	MOLs
AATCACGCAAGATGGC	Microglia
AATCACGCACGCACCA	OPCs
AATCACGCATGTACGT	MOLs
AATCACGGTCGCTTAA	ExciteL4
AATCACGTCACTTGGA	ExciteL6
AATCACGTCCCATAGA	MOLs
AATCACGTCGCCAATA	MOLs
AATCGACCACACGGTC	OPCs
AATCGACGTACAATAG	MOLs
AATCGACGTCTTACAG	ExciteL4
AATCGTGAGCTGGTGA	Astrocytes
AATCGTGAGGCACCAA	COPs
AATCGTGAGGCGTTGA	Astrocytes
AATCGTGCACAGCGCT	NIPCs
AATCGTGCATGGCTGC	Astrocytes
AATCGTGGTACGAGTG	OPCs
AATCGTGGTACGTTCA	Astrocytes
AATCGTGGTCCACGCA	InhibNeuron
AATCGTGTCCCTCGAT	InhibNeuron
AATCGTGTCCTACGAA	MOLs
AATGAAGAGACGAAGA	Microglia
AATGAAGAGGTTGACG	Microglia
AATGAAGAGTAACAGT	InhibNeuron
AATGAAGAGTGGACGT	Microglia
AATGAAGCAAACCGGA	Fibroblasts
AATGAAGCAAGCGGAT	ExciteL4
AATGAAGCAATCAGCT	ExciteL23
AATGAAGCAGCTGTCG	ExciteL6
AATGAAGGTACACGTT	Microglia
AATGAAGGTCATCGCG	ExciteNP
AATGAAGGTTACGCCG	ExciteNP
AATGAAGTCACCCTGT	MOLs
AATGAAGTCGATGGAG	ExciteL4
AATGAAGTCGGTGTTA	MOLs
AATGACCAGATAACGT	ExciteL5
AATGACCAGATTGCGG	Pericytes
AATGACCCATTGTAGC	ExciteL4
AATGACCTCAGTAGGG	InhibNeuron
AATGCCAAGCTAAGTA	InhibNeuron
AATGCCACAAAGAGTT	ExciteL4
AATGCCACAAGCGGAT	Microglia
AATGCCACAGAGTAAT	MOLs
AATGCCACATCTGGGC	MOLs
AATGCCACATGGGCAA	MOLs
AATGCCAGTAATACCC	Astrocytes
AATGCCAGTATAGGAT	Microglia
AATGCCAGTCAGGTGA	Microglia
AATGCCAGTGTCCTAA	Pericytes
AATGCCAGTTAGAAGT	NIPCs
AATGCCATCACATACG	ExciteL5
AATGGAAAGAGAACCC	ExciteL4
AATGGAAAGTTCTCTT	ExciteL5
AATGGAACACTAAACC	ExciteL5
AATGGAAGTACTCGCG	OPCs
AATGGAAGTCGAGCAA	MOLs
AATGGAAGTCTTACTT	Astrocytes
AATGGAATCATAGCAC	MOLs
AATGGAATCCATCTGC	ExciteL4
AATGGAATCCTCACCA	COPs
AATGGCTAGTATAGAC	ExciteL6
AATGGCTCATAATGCC	MOLs
AATGGCTCATTAGGCT	OPCs
AATGGCTGTACTGCGC	COPs
AATGGCTGTCCAATCA	ExciteL6
AATGGCTGTGTTAAAG	ExciteL4
AATGGCTGTTGACTAC	MOLs
AATGGCTTCCGTGTCT	OPCs
AATGGCTTCCTCTCGA	NIPCs
AATTCCTCATCCTATT	ExciteL6
AATTCCTTCGCTAATG	Astrocytes
AATTCCTTCGTAACAC	Microglia
AATTCCTTCTCTAAGG	Microglia
AATTCCTTCTGTGCTC	Astrocytes
AATTCCTTCTTCCGTG	OPCs
AATTTCCAGCACCAGA	MOLs
AATTTCCAGCTTGTGT	MOLs
AATTTCCAGGACGGAG	MOLs
AATTTCCAGGGATCGT	OPCs
AATTTCCAGTTCATCG	Microglia
AATTTCCCAGCCTTCT	COPs
AATTTCCCAGTTCTAG	Microglia
AATTTCCGTAAGATAC	Astrocytes
AATTTCCGTCACTCGG	ExciteL23
AATTTCCGTCCACTTC	OPCs
AATTTCCGTGAGATTA	MOLs
AATTTCCTCCATTCAT	MOLs
AATTTCCTCCCTTGGT	MOLs
ACAAAGAAGCAATAAC	Microglia
ACAAAGAAGTAGCTCT	MOLs
ACAAAGAAGTTGCTCA	OPCs
ACAAAGACACCCTGTT	MOLs
ACAAAGACAGATACTC	COPs
ACAAAGACAGTCGGTC	MOLs
ACAAAGACATACAGAA	Microglia
ACAAAGAGTCAAGTTC	Microglia
ACAAAGAGTTCAAGGG	ExciteL4
ACAAAGAGTTCTTAGG	NIPCs
ACAAAGATCACGTCCT	Endo
ACAAAGATCAGGACAG	MOLs
ACAAAGATCGAGAATA	MOLs
ACAAAGATCTTCGATT	OPCs
ACAACCAAGATTGACA	InhibNeuron
ACAACCAAGGGTGAAA	Endo
ACAACCAAGTCGTCTA	Microglia
ACAACCACAAAGACGC	ExciteL5
ACAACCACACGTCTCT	Microglia
ACAACCAGTCATTGCA	MOLs
ACAACCATCAATCGGT	ExciteL5
ACAACCATCGAATCCA	MOLs
ACAACCATCGTTCCTG	OPCs
ACAACCATCTTAGCTT	ExciteL4
ACAAGCTCACGACCTG	OPCs
ACAAGCTCACGATTCA	Microglia
ACAAGCTCATAGGTTC	Microglia
ACAAGCTCATCCTCAC	Microglia
ACAAGCTGTAGAGTTA	MOLs
ACAAGCTGTCCATCTC	ExciteNP
ACAAGCTGTCTTCGAA	Microglia
ACAAGCTTCAACTTTC	Astrocytes
ACAAGCTTCCTGTAAG	MOLs
ACACAGTAGTTCTCTT	Microglia
ACACAGTCAAGCGGAT	OPCs
ACACAGTCACATAACC	COPs
ACACAGTCACCGGCTA	Microglia
ACACAGTCACCTTCCA	OPCs
ACACAGTGTCCTATAG	OPCs
ACACAGTTCACTGATG	Astrocytes
ACACAGTTCCGCCTAT	MOLs
ACACAGTTCCTACACC	MOLs
ACACAGTTCTTCTCAA	ExciteNP
ACACCAAAGAACAAGG	COPs
ACACCAACAACCGTAT	ExciteL6
ACACCAACACGCGTGT	OPCs
ACACCAACATGTTTGG	Microglia
ACACCAAGTCCCGCAA	Endo
ACACCAAGTCGCGGTT	MOLs
ACACCAAGTCGGAAAC	Astrocytes
ACACCAAGTGTCCGTG	ExciteL23
ACACCAAGTTCATCTT	Microglia
ACACCAATCAGCAATC	ExciteL4
ACACCAATCAGTCTTT	ExciteL4
ACACCAATCCATACTT	ExciteL4
ACACCAATCGATGGAG	NIPCs
ACACCAATCTATCGGA	ExciteL23
ACACCAATCTCGACGG	Microglia
ACACCAATCTTGTTAC	OPCs
ACACGCGAGAACGCGT	InhibNeuron
ACACGCGAGATCACTC	OPCs
ACACGCGAGTCCCAGC	Microglia
ACACGCGCACGTGAGA	Macrophages
ACACGCGTCACGATAC	COPs
ACACGCGTCAGTCCGG	Microglia
ACACGCGTCATGACAC	Microglia
ACACTGAAGCGGGTTA	Microglia
ACACTGAAGGTTAAAC	MOLs
ACACTGAGTGCAGGAT	Microglia
ACACTGATCATTCATC	MOLs
ACACTGATCCTTACCG	OPCs
ACACTGATCTTACCAT	MOLs
ACAGAAAAGACCGCCT	Astrocytes
ACAGAAAAGGTTGGAC	OPCs
ACAGAAAAGTGCCAGA	ExciteL4
ACAGAAACACGGTGAA	Microglia
ACAGAAACAGGCATTT	ExciteL6
ACAGAAAGTACTAACC	ExciteL4
ACAGAAAGTCCTTTGC	Astrocytes
ACAGAAAGTGCAGATG	ExciteL23
ACAGAAATCGTACCTC	Endo
ACAGCCGAGAGCGACT	MFOLs
ACAGCCGAGCCACTCG	OPCs
ACAGCCGAGGAAAGAC	Microglia
ACAGCCGAGTGCAAAT	Microglia
ACAGCCGCAACCGATT	Microglia
ACAGCCGCATCTCAAG	MOLs
ACAGCCGTCTGTACAG	Microglia
ACAGCCGTCTTCTGTA	Astrocytes
ACAGGGAAGCGTCTGC	Microglia
ACAGGGACATCACAGT	Microglia
ACAGGGAGTATCACCA	Astrocytes
ACAGGGAGTCTTTCTA	Astrocytes
ACAGGGAGTGACGTCC	ExciteL6
ACAGGGAGTGAGTGAC	MOLs
ACAGGGATCAAATGAG	Microglia
ACATCCCAGGTCTACT	ExciteL6
ACATCCCCACAACATC	Pericytes
ACATCCCCACTGATTG	ExciteL4
ACATCCCCATGACTTG	OPCs
ACATCCCGTACTCCGG	InhibNeuron
ACATCCCGTATATGGA	MOLs
ACATCCCTCCCTCGTA	Microglia
ACATCCCTCGAAACAA	ExciteL4
ACATCGAAGGCTTAAA	Microglia
ACATCGAAGTCTCTGA	ExciteL4
ACATCGAAGTGAACAT	ExciteL4
ACATCGACAAGCCCAC	NIPCs
ACATCGACAATGTCAC	ExciteL4
ACATCGACACTGCGTG	OPCs
ACATCGACATAACAGA	ExciteL4
ACATCGAGTAGCGTAG	MOLs
ACATCGAGTTGGTACT	ExciteL6
ACATCGATCATTCACT	ExciteL4
ACATCGATCTTACGGA	NIPCs
ACATGCAAGTCTGCAT	ExciteL6
ACATGCAGTAATTAGG	ExciteL23
ACATGCAGTCAAGTTC	Microglia
ACATTTCAGACCTCAT	MOLs
ACATTTCAGCTTCGTA	ExciteL5
ACATTTCAGTCACTAC	Microglia
ACATTTCAGTCATACC	MOLs
ACATTTCCAAACACCT	Astrocytes
ACATTTCCAAGGTACG	Microglia
ACATTTCCAGGAATCG	OPCs
ACATTTCGTATCACGT	InhibNeuron
ACATTTCGTTAGAGTA	OPCs
ACATTTCGTTCCGTTC	ExciteL4
ACATTTCTCCGCACGA	MOLs
ACATTTCTCTGGTTGA	InhibNeuron
ACCAAACAGAGCACTG	Astrocytes
ACCAAACAGTTAGAAC	OPCs
ACCAAACCAAGTGACG	InhibNeuron
ACCAAACCATCCGTGG	ExciteL6
ACCAAACGTACAACGG	Microglia
ACCAAACGTCATTGCA	ExciteL4
ACCAAACTCCTAGCTC	OPCs
ACCAACAAGAGGTCGT	Astrocytes
ACCAACAAGATGTTAG	MOLs
ACCAACACATGTGTCA	MOLs
ACCAACAGTGAACGGT	ExciteL4
ACCAACAGTGTGACCC	Microglia
ACCACAAAGATCACTC	MOLs
ACCACAAAGGCTGAAC	ExciteL6
ACCACAAAGGGTGAGG	ExciteL6
ACCACAAGTACAATAG	ExciteL4
ACCACAAGTCGCTTAA	MOLs
ACCACAAGTCTCCCTA	Microglia
ACCACAAGTTGAAGTA	Microglia
ACCACAATCAAGTCGT	InhibNeuron
ACCATTTAGACTAAGT	MOLs
ACCATTTAGTCTGCGC	MOLs
ACCATTTCAGAACATA	InhibNeuron
ACCATTTTCAAGTAAG	Microglia
ACCCAAAGTAAGGCTG	MOLs
ACCCAAAGTAGAGTTA	MOLs
ACCCAAATCAACCGAT	ExciteNP
ACCCAAATCGCAATGT	Astrocytes
ACCCAAATCGTGGCTG	NIPCs
ACCCTCAAGACATATG	ExciteNP
ACCCTCACACGATAGG	MOLs
ACCCTCAGTAGTCTGT	Microglia
ACCCTCAGTCAAACGG	MOLs
ACCCTCAGTCATGACT	InhibNeuron
ACCCTCAGTCTGTCAA	ExciteL4
ACCCTCAGTTAGGAGC	Microglia
ACCCTTGAGGGTTAGC	Macrophages
ACCCTTGAGTTGGCGA	ExciteL6
ACCCTTGCATGCACTA	NIPCs
ACCCTTGGTATGAGAT	Astrocytes
ACCCTTGGTGCTTCAA	ExciteNP
ACCCTTGGTGGCCCAT	InhibNeuron
ACCCTTGGTTTCACAG	ExciteL5
ACCCTTGTCCGCATAA	OPCs
ACCCTTGTCTGCGAGC	MOLs
ACCGTTCCAGAAGCTG	Macrophages
ACCGTTCCATGGCTGC	Microglia
ACCGTTCGTCACAGTT	NIPCs
ACCGTTCGTCTTCATT	Astrocytes
ACCGTTCTCAAGGACG	MFOLs
ACCGTTCTCGGTAGGA	COPs
ACCGTTCTCTTAGCCC	Microglia
ACCTACCAGCTGTTAC	ExciteL4
ACCTACCAGGCTTCCG	MOLs
ACCTACCCATCGCTAA	OPCs
ACCTACCTCCGATGCG	MOLs
ACCTACCTCGTCCTCA	ExciteL23
ACCTACCTCTTACCGC	MOLs
ACCTGAAAGATAGTCA	Microglia
ACCTGAAAGCCATTGT	COPs
ACCTGAACAACAGATA	InhibNeuron
ACCTGAACACAGCTGC	ExciteL6
ACCTGAAGTACGACAG	OPCs
ACCTGAAGTGTTTCTT	Astrocytes
ACCTGTCAGGGAGATA	ExciteL4
ACCTGTCCAACAGCCC	Astrocytes
ACCTGTCCATATGCGT	Microglia
ACCTGTCTCAGTGTGT	ExciteL6
ACGATCAAGGCTTCCG	MOLs
ACGATCACACAAGTTC	MOLs
ACGATCACAGGGTCTC	ExciteL6
ACGATCACATCGATCA	Astrocytes
ACGATCAGTCGAACGA	ExciteL4
ACGATCAGTGTACGCC	ExciteL6
ACGATCAGTGTTACAC	OPCs
ACGATCATCATCCCGT	ExciteL4
ACGATGTAGACTCGAG	Microglia
ACGATGTAGCGTGTTT	Microglia
ACGATGTCAGATACCT	Microglia
ACGATGTTCATGGCCG	Astrocytes
ACGATGTTCCTGGCTT	ExciteL4
ACGATGTTCGCAGTTA	OPCs
ACGATGTTCTGCGAGC	OPCs
ACGCACGAGAAGGGAT	Microglia
ACGCACGAGATTGACA	ExciteNP
ACGCACGAGCCAAGGT	MOLs
ACGCACGAGGAACGAA	MOLs
ACGCACGCACTGCGAC	ExciteL4
ACGCACGCAGAGCGTA	MOLs
ACGCACGGTCGCGTTG	ExciteL6
ACGCACGGTGAAGCTG	ExciteL6
ACGCACGGTGTCCGGT	COPs
ACGCACGGTTTCGTGA	ExciteL5
ACGGAAGCACGTAGAG	ExciteL5
ACGGGTCAGACCGTTT	InhibNeuron
ACGGGTCAGAGAGCCT	Astrocytes
ACGGGTCAGAGGTGCT	Microglia
ACGGGTCAGTCGCTAT	Microglia
ACGGGTCCATAATGAG	Microglia
ACGGGTCGTAACGGTG	MOLs
ACGGGTCTCGAGATAA	ExciteL4
ACGGGTCTCTTACTGT	MOLs
ACGGGTCTCTTGAGCA	Astrocytes
ACGGTCGAGATCACCT	OPCs
ACGGTCGAGGAAGTGA	ExciteL4
ACGGTCGAGGAGAGGC	ExciteL5
ACGGTCGAGGCTTAAA	Astrocytes
ACGGTCGCATGGACAG	ExciteL4
ACGGTCGGTCGCATTA	ExciteL4
ACGGTCGGTGTGTGGA	COPs
ACGGTTAAGTTAGTAG	MOLs
ACGGTTAAGTTGCGCC	ExciteL23
ACGGTTACAATGAAAC	InhibNeuron
ACGGTTACAGATCCAT	Pericytes
ACGGTTAGTAGCGCTC	Fibroblasts
ACGGTTAGTAGTGCGA	OPCs
ACGGTTAGTCTTTCTA	ExciteL5
ACGGTTATCGCAGATT	Microglia
ACGGTTATCTCATGCC	Microglia
ACGTAACAGCAGGGAG	MOLs
ACGTAACAGGAACGTC	Microglia
ACGTAACAGGTCGAGT	InhibNeuron
ACGTAACAGTAGGAAG	ExciteL4
ACGTAACCACAGGATG	MOLs
ACGTAACGTAGTTCCA	Astrocytes
ACGTAACGTCGTTTCC	MOLs
ACGTAACGTTGCGAAG	MOLs
ACGTAACTCTGCGGAC	ExciteL6
ACGTACAAGACTCTAC	OPCs
ACGTACACACAACCGC	OPCs
ACGTACACACTTGAAC	ExciteL4
ACGTACACAGCGTTTA	MOLs
ACGTACACATCTAACG	NIPCs
ACGTACAGTATTGACC	OPCs
ACGTACATCAGATGCT	ExciteL23
ACGTACATCATGGATC	OPCs
ACGTACATCGGACTTA	MOLs
ACGTACATCTATCGCC	MOLs
ACGTAGTAGCCGTTAT	MOLs
ACGTAGTCATAGAATG	ExciteL23
ACGTAGTGTCTGCAAT	ExciteL6
ACGTCCTAGCTACAAA	MOLs
ACGTCCTAGCTGACAG	ExciteL6
ACGTCCTCAGTTCTAG	Microglia
ACGTCCTGTAAGATAC	Pericytes
ACGTCCTGTTGTCAGT	OPCs
ACGTCCTTCTCCGAAA	OPCs
ACGTTCCAGATAGCTA	ExciteL6
ACGTTCCAGCCAAGCA	OPCs
ACGTTCCCAAGGCGTA	NIPCs
ACGTTCCCACGGCACT	MOLs
ACGTTCCGTGGTTTGT	MOLs
ACTACGAAGATTGACA	Microglia
ACTACGACAGCATACT	NIPCs
ACTACGAGTCAGTCCG	MOLs
ACTACGAGTGCAGTGA	Microglia
ACTACGATCCATAGGT	Astrocytes
ACTACGATCGGTGCAC	Astrocytes
ACTATCTAGAAGTATC	ExciteL6
ACTATCTAGTGCAACG	Microglia
ACTATCTCAACATCGT	OPCs
ACTATCTCAGCAGGAT	ExciteL4
ACTATCTGTTAAGACA	ExciteL4
ACTATCTGTTGATGTC	ExciteL4
ACTATCTTCGACATCA	ExciteL4
ACTATGGCAAATACGA	Microglia
ACTATGGGTAGATTGA	MOLs
ACTATGGGTAGCCAGA	ExciteL4
ACTATGGGTGCCTTCT	ExciteL4
ACTATGGTCACGGACC	Microglia
ACTATGGTCCAGCACG	MOLs
ACTATTCAGCACGGAT	Microglia
ACTATTCCAAAGCGTG	MOLs
ACTATTCCAAGTTGGG	Astrocytes
ACTATTCCACTTCATT	Fibroblasts
ACTATTCGTCAAGCCC	Astrocytes
ACTATTCGTTTCGACA	OPCs
ACTATTCTCAGGACGA	OPCs
ACTATTCTCCACACCT	ExciteL23
ACTATTCTCCACGAAT	ExciteL23
ACTCCCAAGCGTCGAA	OPCs
ACTCCCACACTAGTAC	MOLs
ACTCCCACACTCAAGT	OPCs
ACTCCCAGTGCCGAAA	Astrocytes
ACTCCCAGTGCCTGCA	Microglia
ACTCCCATCCTTTGAT	Microglia
ACTCCCATCGGCTTGG	ExciteL23
ACTCTCGAGACAAGCC	ExciteL4
ACTCTCGAGCGTGAGT	ExciteL4
ACTCTCGAGTATAACG	Endo
ACTCTCGCAGGATCTT	Astrocytes
ACTCTCGGTACGTAGG	ExciteL6
ACTCTCGGTATCGTGT	ExciteL4
ACTCTCGTCACGTCCT	OPCs
ACTCTCGTCAGGGATG	MOLs
ACTGATGCAATTGAGA	ExciteL5
ACTGATGCACTAAACC	Astrocytes
ACTGATGGTAGCGATG	ExciteL6
ACTGATGGTGATACAA	ExciteL6
ACTGATGGTGGAACAC	OPCs
ACTGATGGTGGTCTGC	MOLs
ACTGATGTCCCTCTAG	Endo
ACTGCAAAGCATAGGC	ExciteL6
ACTGCAAAGGAGGGTG	ExciteL4
ACTGCAACACCGCTGA	ExciteL6
ACTGCAAGTATGCTAC	Microglia
ACTGCAAGTCCTCCAT	OPCs
ACTGCAAGTGTACATC	MOLs
ACTGCAATCAAGGTGG	Microglia
ACTGCAATCATTACGG	MOLs
ACTGCAATCGTAATGC	ExciteL4
ACTGTCCCACTAGGTT	Endo
ACTGTCCCACTGCTTC	Microglia
ACTGTCCCATCTTCGC	COPs
ACTGTCCTCGCTACGG	COPs
ACTGTGAAGCGTGTCC	InhibNeuron
ACTGTGAAGGCACTCC	Microglia
ACTGTGACAAGGTCAG	Astrocytes
ACTGTGACACCACATA	MOLs
ACTGTGACAGACTCTA	Endo
ACTGTGAGTAGACACG	Microglia
ACTGTGAGTATCATGC	ExciteL4
ACTGTGAGTGACAGGT	Macrophages
ACTGTGATCAAGCCTA	ExciteL4
ACTGTGATCCCAACTC	ExciteL4
ACTGTGATCCGATGTA	MOLs
ACTGTGATCGTAACTG	ExciteL23
ACTTAGGAGCCTCATA	Microglia
ACTTAGGAGGAGCTGT	Microglia
ACTTAGGCAACAGAGC	MOLs
ACTTAGGTCCGTTGGG	Astrocytes
ACTTATCAGAAGATCT	Astrocytes
ACTTATCAGATTACCC	Microglia
ACTTATCAGGTAAACT	Microglia
ACTTATCAGTTGGACG	ExciteL4
ACTTATCCACTCCACT	OPCs
ACTTATCTCGTTCATT	OPCs
ACTTCCGCAATGGGTG	Astrocytes
ACTTCCGCACAAATAG	Fibroblasts
ACTTCCGGTCGACTTA	MOLs
ACTTCCGGTCGCACAC	ExciteL23
ACTTCCGTCAACCTCC	MOLs
ACTTCGCCAACTCATG	OPCs
ACTTCGCCAAGTGTCT	ExciteL6
ACTTCGCCACAATTCG	Microglia
ACTTCGCCAGAGTTCT	Microglia
ACTTCGCCAGCGTGAA	ExciteL4
ACTTCGCTCGCCAATA	ExciteL23
ACTTCGCTCGGTCGAC	ExciteL6
ACTTTCAAGGTACATA	ExciteL6
ACTTTCAAGGTCGCCT	ExciteL4
ACTTTCACAGTGCCTG	Pericytes
ACTTTCACATCATGAC	ExciteL6
ACTTTCACATGAATAG	ExciteL6
ACTTTCAGTCACTGAT	ExciteL6
ACTTTCAGTGCATACT	OPCs
ACTTTCAGTGCCTATA	MFOLs
ACTTTGTAGAAGCGGG	ExciteL23
ACTTTGTCACTAGTAC	Astrocytes
ACTTTGTGTCCAACGC	Microglia
ACTTTGTTCGAGTGAG	Astrocytes
AGAAATGAGAGTATAC	ExciteL6
AGAAATGAGCAGCGAT	ExciteL4
AGAAATGCAACAGCTT	Microglia
AGAAATGCACATAGCT	ExciteL6
AGAAATGCATGGAACG	NIPCs
AGAACAAAGGAAGTCC	ExciteL6
AGAACAAAGGTCGCCT	MFOLs
AGAACAACACATTCTT	ExciteL6
AGAACAACACCTCTGT	InhibNeuron
AGAACAATCCATCACC	Microglia
AGAACAATCTCCCTAG	ExciteL6
AGAACCTAGACTTGTC	Microglia
AGAACCTAGCCGATAG	MOLs
AGAACCTAGGCAGGTT	ExciteL23
AGAACCTAGGGAGATA	InhibNeuron
AGAACCTAGTGGATTA	MOLs
AGAACCTGTACGCTAT	COPs
AGAACCTGTATAATGG	ExciteL23
AGAACCTGTCGATTAC	Microglia
AGAACCTTCACCCTGT	ExciteL23
AGAACCTTCTATTTCG	Astrocytes
AGAAGCGAGCAAACAT	Microglia
AGAAGCGAGTCGGGAT	MOLs
AGAAGCGCAGTTTCAG	ExciteL23
AGAAGCGCATGGCTAT	MOLs
AGAAGCGGTTCAATCG	Microglia
AGAAGCGGTTGTCATG	Microglia
AGAAGCGTCATGGATC	MOLs
AGAAGCGTCCAAGAGG	Pericytes
AGAAGCGTCGGAAACG	ExciteL23
AGAAGTAAGGGAACAA	InhibNeuron
AGAAGTACAACTGGTT	Microglia
AGAAGTACAAGCGAAC	Microglia
AGAAGTACACGCTGAC	Microglia
AGAAGTAGTCAAATCC	ExciteL5
AGAAGTAGTCGTTGCG	ExciteL4
AGAAGTAGTGTTAAAG	ExciteL4
AGAAGTATCCTCTCTT	NIPCs
AGACAAAAGATAGTGT	OPCs
AGACAAAAGGCTAAAT	Astrocytes
AGACAAAAGTGGCAGT	MOLs
AGACAAACAAGGCAAC	ExciteL4
AGACAAACACCAACAT	OPCs
AGACAAACACTGCACG	COPs
AGACAAAGTATTGACC	OPCs
AGACAAAGTCCGGTGT	MOLs
AGACAAAGTGAATATG	ExciteL4
AGACAAATCACTACGA	Astrocytes
AGACAAATCATCGCAA	InhibNeuron
AGACAAATCTCGGCTT	ExciteL6
AGACAAATCTGATGGT	Microglia
AGACACTCACGCGCTA	ExciteL23
AGACACTGTGCCCACA	OPCs
AGACACTGTTGGACCC	MOLs
AGACACTTCGATACAC	ExciteL5
AGACAGGAGGCTTAAA	ExciteL4
AGACAGGCAACAAGTA	Astrocytes
AGACAGGCAACCGTGC	InhibNeuron
AGACAGGCAATAGAGT	ExciteL4
AGACAGGCAGGACAGT	MOLs
AGACAGGGTAGTATAG	Microglia
AGACAGGGTGCCTAAT	ExciteL4
AGACAGGGTGCGAACA	MOLs
AGACAGGGTGGATACG	Microglia
AGACCATAGAAACTCA	Astrocytes
AGACCATAGACCTTTG	OPCs
AGACCATAGGAAGTCC	ExciteNP
AGACCATAGGGCGAAG	Microglia
AGACCATAGGTTTGAA	MOLs
AGACCATCAGTGACCC	Astrocytes
AGACCATCATAGGCGA	Microglia
AGACCATGTGGCTTGC	Microglia
AGACCATGTTACGATC	ExciteL23
AGACCATGTTCCGTTC	ExciteL4
AGACCATGTTGGACCC	Microglia
AGACCATTCAAGGACG	COPs
AGACCATTCCAATGCA	Microglia
AGACCATTCTCTTCAA	Microglia
AGACCCGAGAGCACTG	OPCs
AGACCCGCAAGTTCCA	Microglia
AGACCCGCACTTGTCC	Microglia
AGACCCGGTCACCTTC	Microglia
AGACCCGGTCAGACTT	MOLs
AGACCCGGTCCATACA	InhibNeuron
AGACCCGGTCGAGCAA	InhibNeuron
AGACCCGGTGGCCACT	MOLs
AGACCCGGTTAACAGA	ExciteL6
AGACCCGGTTTGAACC	ExciteNP
AGACCCGTCCTTGACC	MOLs
AGACCCGTCTCCAATT	MOLs
AGACTCAAGCTAAACA	MOLs
AGACTCACAATTGGTC	OPCs
AGACTCACACTTGAGT	MOLs
AGACTCACATCGTCCT	ExciteL6
AGACTCACATCTAACG	Astrocytes
AGACTCAGTAAGCTCT	Astrocytes
AGACTCAGTCACAGTT	Microglia
AGACTCAGTCGCCACA	OPCs
AGACTCATCCTGCCAT	MOLs
AGAGAATCACAAATAG	MOLs
AGAGAATTCAACGAGG	Microglia
AGAGAATTCCACAAGT	Microglia
AGAGAGCAGATGCCGA	MOLs
AGAGAGCAGGGTCTTT	Microglia
AGAGAGCCACATAGCT	OPCs
AGAGAGCCACGACTAT	InhibNeuron
AGAGAGCCATGTTACG	Astrocytes
AGAGAGCGTGCATTAC	Microglia
AGAGAGCTCGTCAGAT	Macrophages
AGAGCAGAGCCGCTTG	ExciteL4
AGAGCAGAGGACTGGT	ExciteL6
AGAGCAGCAGGAATCG	Astrocytes
AGAGCAGGTGACAGGT	ExciteL4
AGAGCAGGTTAGAGAT	ExciteL4
AGAGCCCAGAGCCTGA	Astrocytes
AGAGCCCCATCCAACA	ExciteL6
AGAGCCCGTAGGAGGG	Astrocytes
AGAGCCCGTCCACAGC	ExciteL4
AGAGCCCGTTGTGCAT	Astrocytes
AGAGCCCTCGAGTGAG	MOLs
AGATAGAAGCGACTAG	ExciteL4
AGATAGAAGGAAAGAC	OPCs
AGATAGACACCTGCGA	MOLs
AGATAGACATAGTCAC	Astrocytes
AGATAGACATCATCTT	MOLs
AGATCCAAGGGACAGG	Macrophages
AGATCCAAGTTCTACG	ExciteNP
AGATCCACAGTTTCAG	MOLs
AGATCCACATAATCGC	MOLs
AGATCCAGTACGGCAA	MOLs
AGATCCATCCGTGGTG	ExciteL4
AGATCCATCGAGGCAA	Microglia
AGATCCATCTGACCCT	Microglia
AGATCGTAGGGTTGCA	ExciteL6
AGATCGTGTGTTATCG	MOLs
AGATGAAAGACTCTTG	InhibNeuron
AGATGAACACACCTTC	MOLs
AGATGAAGTACGATGG	Microglia
AGATGAAGTTCGGCGT	OPCs
AGATGAATCACCGCTT	InhibNeuron
AGATGAATCCGCAACG	ExciteL4
AGATGCTAGTACAGCG	ExciteL4
AGATGCTAGTGGAAAG	Microglia
AGATGCTCAAACCACT	MOLs
AGATGCTCACAAATGA	ExciteL6
AGATGCTCATATAGCC	MOLs
AGATGCTCATTGGGAG	Microglia
AGATGCTGTATCACCA	ExciteL4
AGATGCTGTCACTCGG	Microglia
AGATGCTGTCGCATGC	ExciteL5
AGATGCTGTGACTGTT	ExciteL6
AGATGCTGTTACCCAA	Microglia
AGATGCTGTTCTCCTG	OPCs
AGATGCTTCCGCATAA	ExciteL4
AGCATCAAGAGGGTAA	ExciteL4
AGCATCAAGAGTCCGA	Microglia
AGCATCAAGATGCGAC	ExciteL4
AGCATCAAGCACTGGA	ExciteL4
AGCATCACAACTCCAA	MOLs
AGCATCAGTAAGCGGT	MOLs
AGCATCAGTACCGCGT	ExciteL5
AGCATCAGTGCGAGTA	ExciteL6
AGCATCAGTTTGAACC	OPCs
AGCATCATCAACGTGT	ExciteL4
AGCCAATAGCCGATAG	MOLs
AGCCAATAGTATGCAA	ExciteL4
AGCCAATCACCCATAA	Microglia
AGCCAATCACCTCAGG	ExciteL6
AGCCAATGTTTACGAC	ExciteL23
AGCCAATTCAAACCTG	Astrocytes
AGCCAATTCTGGCCTT	Endo
AGCCACGCATCTATCT	ExciteL4
AGCCACGCATGGAACG	ExciteL5
AGCCACGCATTGCAAC	Microglia
AGCCACGGTAGTTCCA	Microglia
AGCCACGTCCTCTCTT	MOLs
AGCCAGCAGAATCCCT	ExciteL6
AGCCAGCAGAGTCAAT	ExciteL6
AGCCAGCAGCGAGTCA	ExciteL4
AGCCAGCCACGACAAG	Microglia
AGCCAGCCAGAGTTCT	COPs
AGCCAGCGTAACTGCT	ExciteL5
AGCCAGCGTAGCCCTG	Microglia
AGCCAGCGTAGCGAGT	OPCs
AGCCAGCGTTGCTCGG	ExciteL23
AGCCAGCGTTTCGATG	Microglia
AGCCAGCTCGACGCTG	OPCs
AGCGATTAGCGATGAC	ExciteL4
AGCGATTAGGCTGTAG	MOLs
AGCGATTAGGGTCTTT	MOLs
AGCGATTAGGTCGTGA	ExciteL6
AGCGATTAGTATCTGC	ExciteL4
AGCGATTAGTCGCGAA	ExciteL6
AGCGATTCAAACTCGT	Ependymal
AGCGATTCAAGAGGCT	OPCs
AGCGATTCAGAAGCGT	ExciteL6
AGCGATTCAGGACTTT	Microglia
AGCGATTCAGGCCCTA	ExciteL4
AGCGATTCATCCGTGG	ExciteL6
AGCGATTGTATAATGG	MOLs
AGCGATTGTGTTACAC	Microglia
AGCGCCAAGCATGTTC	ExciteL6
AGCGCCAAGCGTGAAC	Astrocytes
AGCGCCAAGGGCCAAT	ExciteL6
AGCGCCAAGGGTGAAA	ExciteL5
AGCGCCAAGGTAAGAG	MOLs
AGCGCCAAGTAACGAT	InhibNeuron
AGCGCCACAAAGCTCT	Astrocytes
AGCGCCACACAGTGTT	Microglia
AGCGCCACACTCTAGA	Astrocytes
AGCGCCACATGAGAAT	Astrocytes
AGCGCTGAGACGACGT	OPCs
AGCGCTGCAACAAGAT	Astrocytes
AGCGCTGCATCCGGCA	MOLs
AGCGCTGGTAGATGTA	ExciteL23
AGCGCTGTCGTGGGTC	Microglia
AGCGTATAGATCGACG	NIPCs
AGCGTATCAAACGGCA	Microglia
AGCGTATCAACTGCCG	MOLs
AGCGTATCAAGACAAT	Microglia
AGCGTATGTCGAACAG	Microglia
AGCGTATTCATGTCAG	MOLs
AGCGTATTCTAACGCA	OPCs
AGCGTCGCACTCCTTG	ExciteL6
AGCTACAAGGACTATA	ExciteL4
AGCTACACATGACCCG	OPCs
AGCTACAGTAAGATCA	MOLs
AGCTACAGTCAAACGG	ExciteNP
AGCTACAGTCATAACC	MOLs
AGCTACAGTGAAAGTT	ExciteL4
AGCTACAGTGATTCTG	Microglia
AGCTACAGTTTCCATT	Microglia
AGCTACATCCAAGCTA	Microglia
AGCTCAACAATCTCGA	Microglia
AGCTCAAGTAGCACAG	ExciteL5
AGCTCAAGTGTAACGG	ExciteL4
AGCTCAAGTTCCATTT	Microglia
AGCTCAAGTTGGGTTT	ExciteL5
AGCTCAATCTCGGCTT	MOLs
AGCTTCCAGCAACAAT	ExciteL4
AGCTTCCAGGAAACGA	Microglia
AGCTTCCAGGGCATGT	MOLs
AGCTTCCCACGGATCC	ExciteL6
AGCTTCCGTAACACGG	MOLs
AGCTTCCGTCATTCCC	InhibNeuron
AGCTTCCTCGTGGGTC	MOLs
AGCTTCCTCTGTCCCA	ExciteL4
AGGAAATAGAGCCGTA	Astrocytes
AGGAAATCACCCAATA	InhibNeuron
AGGAAATCAGATACCT	Astrocytes
AGGAAATCAGTCAGAG	Pericytes
AGGAAATGTGTAAATG	OPCs
AGGAAATGTTGTAAAG	ExciteL4
AGGAATAAGGTGCATG	ExciteL4
AGGAATACAGACCAGA	ExciteL6
AGGAATAGTGAGATAT	ExciteL6
AGGAATAGTGGTCTCG	ExciteL4
AGGAATATCAATCTTC	OPCs
AGGAATATCATAGACC	ExciteL4
AGGAATATCGGTAACT	Microglia
AGGACGAAGCTCGAAG	OPCs
AGGACGACATCGCCTT	ExciteL6
AGGACGAGTAGACGGT	ExciteL23
AGGACGAGTCCAGGTC	ExciteL4
AGGACGATCCGGCAGT	ExciteL6
AGGACGATCGGCGATC	MOLs
AGGACGATCTGGCCTT	Microglia
AGGACTTCAGACACCC	Microglia
AGGACTTCAGGTCCCA	ExciteL4
AGGACTTCAGTGCCTG	Microglia
AGGACTTCATGTTTGG	NIPCs
AGGACTTGTAGGAAAG	Microglia
AGGACTTGTATTCCGA	Microglia
AGGACTTGTCGTCAGC	MOLs
AGGACTTTCCCTCAAC	MOLs
AGGACTTTCGCTCATC	ExciteL4
AGGACTTTCGTACCTC	Macrophages
AGGAGGTAGAGTTCGG	ExciteL6
AGGAGGTAGCTTAGTC	ExciteL5
AGGAGGTAGTCCGTCG	ExciteL4
AGGAGGTCAAGAAATC	MFOLs
AGGAGGTCAGACGATG	ExciteL4
AGGAGGTCAGTCTTCC	Astrocytes
AGGAGGTGTAAGCTCT	Astrocytes
AGGAGGTGTCAGTCCG	Microglia
AGGAGGTGTCTTCCGT	ExciteL5
AGGAGGTGTGAATGAT	ExciteL4
AGGAGGTTCAAGGTGG	MOLs
AGGAGGTTCATCACTT	Microglia
AGGATAACACGCCAGT	MOLs
AGGATAACATCACCAA	ExciteL6
AGGATAAGTAGATCGG	NIPCs
AGGATAAGTCACATTG	Microglia
AGGATAAGTGCGTTTA	ExciteL4
AGGATAAGTTGTCTAG	MOLs
AGGATCTAGAATTTGG	ExciteL6
AGGATCTAGGTTGCCC	Astrocytes
AGGATCTAGTCAGCCC	OPCs
AGGATCTCAGGCCTGT	MOLs
AGGATCTGTCAAACGG	Microglia
AGGATCTGTCTGTGCG	Microglia
AGGATCTGTGAAAGTT	ExciteL23
AGGATCTGTTCCTACC	Astrocytes
AGGATCTGTTGGGCCT	Microglia
AGGCATTCACGCGTGT	ExciteL23
AGGCATTCACTCACTC	MOLs
AGGCATTGTACACTCA	ExciteL4
AGGCATTGTGCCAAGA	ExciteL23
AGGCATTGTGTGACCC	MOLs
AGGCATTTCACATACG	ExciteL6
AGGCATTTCATAGACC	Astrocytes
AGGCATTTCCTTCGAC	Microglia
AGGCCACAGAAGCTGC	MOLs
AGGCCACCAACAGCTT	ExciteL6
AGGCCACCACCCTTAC	Astrocytes
AGGCCACCAGCCTACG	InhibNeuron
AGGCCACCATGTGCCG	ExciteL6
AGGCCACGTGGCCACT	ExciteL4
AGGCCACGTGTATTCG	OPCs
AGGCCACTCATGGGAG	ExciteL4
AGGCCACTCTGGGTCG	Microglia
AGGCCACTCTTCCCGA	COPs
AGGCTGCAGCCTTGAT	Microglia
AGGCTGCAGCTAAATG	ExciteL4
AGGCTGCCAACCACAT	OPCs
AGGCTGCCACTGATTG	ExciteL4
AGGCTGCCATGGATCT	ExciteL23
AGGCTGCTCAGCGCAC	ExciteL4
AGGCTGCTCCTACCAC	COPs
AGGCTGCTCCTTCGAC	ExciteL6
AGGCTGCTCTGAATGC	ExciteL5
AGGGAGTAGACGATAT	COPs
AGGGAGTAGCACCGTC	MOLs
AGGGAGTCAAACCATC	ExciteL4
AGGGAGTCAAATGGCG	ExciteL4
AGGGAGTCAACAAGTA	MOLs
AGGGAGTCAGGACAGT	OPCs
AGGGAGTTCGAGTGGA	Microglia
AGGGAGTTCGGCCAAC	MOLs
AGGGAGTTCGTCCTCA	OPCs
AGGGCCTAGAGTGAAG	MOLs
AGGGCCTCACAACATC	ExciteL6
AGGGCCTCACAATGCT	Astrocytes
AGGGCCTCACACAGCC	OPCs
AGGGCCTCACTCTGCT	ExciteL4
AGGGCCTCATCTTCGC	COPs
AGGGCCTGTCGCCACA	Microglia
AGGGCCTGTGACCTGC	ExciteL6
AGGGCCTTCCAATCTT	Astrocytes
AGGGCCTTCCGAGAAG	Microglia
AGGGCTCAGACTCCGC	Astrocytes
AGGGCTCAGTTGGCTT	Astrocytes
AGGGCTCCAAGGTTGG	Endo
AGGGCTCCATGGCGCT	OPCs
AGGGCTCGTTCAATCG	InhibNeuron
AGGGCTCTCATGTCTT	Microglia
AGGGCTCTCTTCTCAA	OPCs
AGGGTCCAGGCCGCTT	ExciteL6
AGGGTCCCAACGGTAG	MOLs
AGGGTCCCAATTGTGC	ExciteL4
AGGGTCCGTCGCCACA	ExciteL5
AGGGTCCGTCTCACGG	ExciteL6
AGGGTCCGTGTTCCAA	ExciteL4
AGGGTCCGTTGCTCGG	ExciteNP
AGGGTCCGTTTCACAG	MOLs
AGGGTCCTCAGCATTG	ExciteL6
AGGGTCCTCATTTCCA	NIPCs
AGGGTCCTCCTAAGTG	ExciteL4
AGGGTCCTCCTGATAG	Microglia
AGGGTCCTCCTTTGAT	MOLs
AGGGTCCTCGATTGGT	Microglia
AGGGTCCTCGGCTGTG	ExciteL6
AGGGTCCTCTCGCGTT	ExciteL6
AGGGTCCTCTTCCTAA	Astrocytes
AGGGTGAAGCGGTAAC	Microglia
AGGGTGAAGGTGCCAA	Microglia
AGGGTGAGTAGTCACT	Microglia
AGGGTGAGTTATTCCT	Astrocytes
AGGGTGAGTTCAGTAC	ExciteL23
AGGGTGAGTTGGGTTT	COPs
AGGGTGATCTATCCAT	ExciteL4
AGGGTGATCTTCTAAC	ExciteL4
AGGGTTTAGGTAAGTT	Microglia
AGGGTTTCACAAATAG	MOLs
AGGGTTTGTTGGTACT	MOLs
AGGGTTTGTTTACCTT	MOLs
AGGGTTTTCAGGGTAG	ExciteL4
AGGTAGGAGGCCACCT	OPCs
AGGTAGGCAAATTGCC	Microglia
AGGTAGGCACTGCGAC	OPCs
AGGTAGGGTCTAACGT	Microglia
AGGTAGGGTGATTGGG	ExciteL23
AGGTAGGTCCAGCAAT	MOLs
AGGTAGGTCGAGCCTG	Microglia
AGGTAGGTCTACGCGG	Microglia
AGGTAGGTCTTTCTAG	ExciteL6
AGGTCATAGTAAACGT	Astrocytes
AGGTCATAGTAACGTA	OPCs
AGGTCATGTAAGTTAG	MOLs
AGGTCATGTACTGCCG	Microglia
AGGTCATGTGTTTCTT	ExciteL4
AGGTCATTCAAAGGAT	Astrocytes
AGGTCATTCATCGCCT	ExciteL6
AGGTCATTCCAATCTT	Microglia
AGGTCTACACGTATAC	MOLs
AGGTCTAGTCGGTGAA	MOLs
AGGTCTAGTTTGTTCT	ExciteL6
AGGTCTATCTGACGCG	OPCs
AGGTGTTCACCGCTGA	MOLs
AGGTGTTCAGTCAACT	ExciteL4
AGGTGTTGTATGCGTT	MOLs
AGGTGTTGTCGTTGGC	ExciteL23
AGGTGTTGTCTAGATC	NIPCs
AGGTGTTGTGCTGATT	ExciteL23
AGGTGTTGTGTCCATA	ExciteL6
AGGTGTTGTTAAAGTG	Macrophages
AGGTTACAGGTGATCG	ExciteL23
AGGTTACAGTTTCGGT	ExciteL4
AGGTTACCAACAGCCC	ExciteL6
AGGTTACCAAGGGTCA	ExciteL4
AGGTTACCACAGTCAT	Microglia
AGGTTACCACGACGCT	Microglia
AGGTTACTCCGTGGCA	ExciteL4
AGGTTACTCGAACTCA	Astrocytes
AGGTTGTGTCAACACT	Microglia
AGGTTGTGTTCTCCCA	Pericytes
AGGTTGTTCAGACAAA	OPCs
AGGTTGTTCTGTCTCG	OPCs
AGTAACCAGCATCCTA	ExciteNP
AGTAACCAGTAGTCAA	MOLs
AGTAACCCAAACACCT	Astrocytes
AGTAACCCAAGATCCT	InhibNeuron
AGTAACCCATCCCACT	MOLs
AGTAACCGTCCGACGT	ExciteL6
AGTAACCTCATAAGGA	Microglia
AGTAACCTCTTCGGAA	ExciteL4
AGTACCACAATGACCT	Astrocytes
AGTACCACACGTAGTT	ExciteL4
AGTACCAGTAGCCAGA	ExciteL4
AGTACCAGTCTTCCGT	ExciteL6
AGTACCAGTGATTCTG	Microglia
AGTACCATCTGCTAGA	ExciteL6
AGTACTGAGCCTGCCA	COPs
AGTACTGAGGCAGGGA	Microglia
AGTACTGCAAGTGGCA	MOLs
AGTACTGCACAACATC	Astrocytes
AGTACTGCACGAAGAC	ExciteL4
AGTACTGGTATACGGG	ExciteL6
AGTACTGGTATCGATC	Microglia
AGTACTGGTGCAGATG	MOLs
AGTACTGTCACGGACC	ExciteL4
AGTACTGTCGAGAATA	Astrocytes
AGTAGCTAGTTGCTGT	NIPCs
AGTAGCTCACGCCACA	OPCs
AGTAGCTCATTGTAGC	ExciteL4
AGTAGCTGTGTCCTAA	ExciteL4
AGTAGTCAGGATACCG	OPCs
AGTAGTCCAGCCCACA	ExciteL23
AGTAGTCCAGCGCGTT	Astrocytes
AGTAGTCCAGCTTCCT	ExciteNP
AGTAGTCGTCCTGTTC	Astrocytes
AGTAGTCGTCGCCTAG	ExciteL4
AGTAGTCGTGTTCCAA	ExciteL4
AGTAGTCGTTCGGCGT	ExciteL5
AGTAGTCTCCGCTGTT	ExciteL23
AGTCAACAGTCTGTAC	MOLs
AGTCAACCAATAAGGT	ExciteL6
AGTCAACCACCAGCGT	Astrocytes
AGTCAACCACCATTCC	Microglia
AGTCAACCAGTCACGC	Astrocytes
AGTCAACCATCCCACT	InhibNeuron
AGTCAACGTCCCTAAA	ExciteL23
AGTCAACGTGTCTCCT	MOLs
AGTCACAAGCACCCAC	MOLs
AGTCACAAGTAGCTCT	ExciteL4
AGTCACAAGTCACAGG	Astrocytes
AGTCACACAGTAACAA	MOLs
AGTCACAGTTAATCGC	Pericytes
AGTCACATCCACAAGT	ExciteL4
AGTCACATCGGCACTG	Microglia
AGTCACATCTGCGGGT	OPCs
AGTCACATCTTGCAGA	ExciteL23
AGTCATGAGCATTGAA	MOLs
AGTCATGAGGTGCCAA	OPCs
AGTCATGAGTGGTCAG	ExciteL23
AGTCATGCACTGGAAG	MOLs
AGTCATGCAGGCCTGT	COPs
AGTCATGGTCGTGGAA	ExciteL5
AGTCATGGTGCATCTA	ExciteL4
AGTCATGGTTAAGCAA	MOLs
AGTCATGGTTGAATCC	OPCs
AGTCATGTCAAACGTC	ExciteL5
AGTCATGTCTGCTGAA	MOLs
AGTCTCCCACTGTTCC	Microglia
AGTCTCCCAGCTACAT	Astrocytes
AGTCTCCCAGGCACTC	Microglia
AGTCTCCCATAGATGA	Microglia
AGTCTCCGTAACTTCG	OPCs
AGTCTCCTCTTAAGGC	OPCs
AGTGACTAGTCATGGG	COPs
AGTGACTCAATCACGT	Microglia
AGTGACTGTACAAAGT	Pericytes
AGTGACTGTAGCACGA	ExciteNP
AGTGACTGTCGCTTAA	ExciteL6
AGTGACTTCAAATGCC	ExciteL4
AGTGACTTCAAGGTGG	ExciteL4
AGTGACTTCAGTGATC	ExciteL23
AGTGACTTCCTGATAG	ExciteL4
AGTGACTTCGAACGCC	ExciteL5
AGTGACTTCGGACTTA	OPCs
AGTGATCAGAGAATCT	MOLs
AGTGATCCACTCAGAT	ExciteNP
AGTGATCCAGACCTAT	Endo
AGTGATCCATAGTCGT	InhibNeuron
AGTGATCGTCTCACAA	Microglia
AGTGATCGTTCCTAAG	ExciteL6
AGTGATCTCGGACTTA	OPCs
AGTGATCTCTATCGGA	ExciteL23
AGTGATCTCTCCAAGA	ExciteL4
AGTGCCGGTACAGTTC	Microglia
AGTGCCGGTCACTAGT	NIPCs
AGTGCCGGTCATCCGG	Microglia
AGTGCCGGTTAGGCCC	MOLs
AGTGCCGGTTGAATCC	ExciteL6
AGTGCCGTCAAAGAAC	Astrocytes
AGTGCCGTCAAGCTGT	OPCs
AGTGCCGTCCAACTAG	MOLs
AGTGCCGTCGGTCAGC	Microglia
AGTGCCGTCTTCCTAA	Microglia
AGTGTTGAGCATTTCG	OPCs
AGTGTTGAGCGTGCTC	Microglia
AGTGTTGCAAATCAAG	Microglia
AGTGTTGCAGCATTGT	ExciteL4
AGTGTTGCAGCCTACG	Astrocytes
AGTGTTGCAGTTGCGC	ExciteL4
AGTGTTGGTGTGACCC	MOLs
AGTGTTGTCTGAGGCC	Microglia
AGTTAGCAGCTAAATG	OPCs
AGTTAGCCAAACTAAG	ExciteL6
AGTTAGCCAAGCAATA	ExciteL6
AGTTAGCCAATGCTCA	OPCs
AGTTAGCCACTCCGGA	ExciteL4
AGTTAGCGTGGTTCTA	Microglia
AGTTAGCTCCGCAACG	ExciteNP
AGTTCCCAGAGACAAG	Microglia
AGTTCCCAGAGTCACG	NIPCs
AGTTCCCAGTGGCCTC	ExciteL6
AGTTCCCCACAAGCCC	ExciteL6
AGTTCCCCATTGCAAC	NIPCs
AGTTCCCTCGCGTGAC	OPCs
AGTTCCCTCGGACTTA	MOLs
AGTTCCCTCTTTGATC	ExciteL6
AGTTCGAAGAAATTGC	ExciteL6
AGTTCGACAACACAAA	MOLs
AGTTCGACAATGGCAG	ExciteL23
AGTTCGACACATGAAA	COPs
AGTTCGAGTACGTTCA	Microglia
AGTTCGAGTTGCATAC	OPCs
AGTTCGATCACGGACC	Astrocytes
AGTTCGATCTCTCTTC	ExciteL6
ATACCGAAGCATCAAA	OPCs
ATACCGAAGTTGTCGT	ExciteL4
ATACCGACATGGAGAC	OPCs
ATACCGAGTCGAATGG	ExciteL6
ATACCGAGTGCAACAG	Microglia
ATACCGAGTTAAGAAC	NIPCs
ATACCGATCATCGCAA	Astrocytes
ATACCGATCTTCGCTG	MOLs
ATACCTTAGAGGACTC	COPs
ATACCTTAGGCATGCA	Macrophages
ATACCTTCAAGGATGC	Microglia
ATACCTTCAGTGACCC	Pericytes
ATACCTTGTACGGATG	ExciteL4
ATACCTTGTCTGTTAG	ExciteL4
ATACCTTGTTACCTTT	ExciteNP
ATACCTTTCTGCATGA	Ependymal
ATACTTCAGAGACAAG	ExciteL6
ATACTTCAGATGAACT	OPCs
ATACTTCAGTAACGAT	COPs
ATACTTCAGTTGCGCC	ExciteL4
ATACTTCCAAACAGGC	ExciteL6
ATACTTCCAAAGGGCT	InhibNeuron
ATACTTCCAGACCTAT	MOLs
ATACTTCCAGCGTTGC	Microglia
ATACTTCGTACTGCGC	OPCs
ATACTTCGTCCTACGG	MOLs
ATACTTCGTCGTCATA	Microglia
ATACTTCGTCTGTGTA	Astrocytes
ATACTTCGTGATAGTA	COPs
ATACTTCTCACGGAGA	MOLs
ATACTTCTCGATTCCC	COPs
ATACTTCTCTGAGGCC	MOLs
ATACTTCTCTTCTTCC	Microglia
ATAGACCAGAAAGCGA	ExciteL4
ATAGACCAGCGTGAGT	Microglia
ATAGACCAGGCTGGAT	OPCs
ATAGACCAGTCACTCA	Pericytes
ATAGACCCACGATTCA	Astrocytes
ATAGACCCATGGTGGA	ExciteL6
ATAGACCGTAAGTTAG	ExciteNP
ATAGACCTCGAATGCT	Microglia
ATAGACCTCTCAAAGC	OPCs
ATAGAGAAGAGCTGCA	InhibNeuron
ATAGAGAAGGCCTGCT	MOLs
ATAGAGACATGTTACG	Astrocytes
ATAGAGAGTCACCGAC	InhibNeuron
ATAGAGAGTCTAGGTT	MOLs
ATAGAGAGTTTAGACC	Microglia
ATAGAGATCAGACCCG	Microglia
ATAGAGATCATTCACT	Astrocytes
ATAGAGATCCATCTGC	Microglia
ATAGAGATCGCGTGCA	OPCs
ATAGAGATCGCTTTAT	MOLs
ATAGGCTCAGCACCCA	NIPCs
ATAGGCTCATCCTATT	ExciteL6
ATAGGCTGTAGGTCAG	ExciteL4
ATATCCTAGTAAACGT	MOLs
ATATCCTCAAGTGGAC	ExciteL6
ATATCCTCATGCACTA	COPs
ATATCCTTCACTGAAC	OPCs
ATATCCTTCTCCGATC	InhibNeuron
ATATCCTTCTGTAACG	InhibNeuron
ATCACAGAGACCTCAT	OPCs
ATCACAGCAAACTAGA	OPCs
ATCACAGCATACACCA	Microglia
ATCACAGCATATGGCT	ExciteL6
ATCACAGGTCATCACA	Microglia
ATCACAGGTGACCGTC	ExciteL6
ATCACGAAGCCAGTAG	ExciteL4
ATCACGAAGTGCACTT	ExciteL6
ATCACGACACCGGCTA	Microglia
ATCACGAGTCGCTGCA	InhibNeuron
ATCACGAGTGACCTGC	Microglia
ATCACGAGTGATCGTT	ExciteL4
ATCACTTAGACAGTCG	MOLs
ATCACTTAGACTTCGT	Astrocytes
ATCACTTCAATACCTG	Microglia
ATCACTTCAGCGACAA	Microglia
ATCACTTCAGTCTACA	ExciteL4
ATCACTTGTACCGGCT	Microglia
ATCACTTGTCAGCTTA	ExciteL23
ATCACTTTCCTGTTGC	OPCs
ATCACTTTCTCTCTTC	InhibNeuron
ATCAGGTAGCCAGAGT	Microglia
ATCAGGTAGCGTTCCG	Microglia
ATCAGGTAGCTGTTCA	Microglia
ATCAGGTAGTGGACGT	Microglia
ATCAGGTCAATCCTTT	Astrocytes
ATCAGGTCAATGCAGG	Astrocytes
ATCAGGTGTGACATCT	InhibNeuron
ATCAGGTTCCGAAATC	Microglia
ATCAGGTTCGCAGAGA	OPCs
ATCATTCCATACTTTC	ExciteL4
ATCATTCGTACTAACC	NIPCs
ATCATTCGTTCCACAA	OPCs
ATCATTCGTTGCCTAA	MOLs
ATCATTCTCAACCTTT	Macrophages
ATCCACCAGGTCACCC	ExciteL5
ATCCACCGTCTAGGTT	OPCs
ATCCATTAGCCTATTG	ExciteL23
ATCCATTAGCGGGTTA	Astrocytes
ATCCATTAGTCTGGTT	Astrocytes
ATCCATTCACTTCTCG	MOLs
ATCCATTGTGTGATGG	Astrocytes
ATCCATTGTGTTGACT	Astrocytes
ATCCCTGCAAGTCCCG	MOLs
ATCCCTGCAATGCAGG	ExciteL4
ATCCCTGCAGCGGATA	OPCs
ATCCCTGCAGTTGTCA	InhibNeuron
ATCCCTGGTCCAAGAG	Microglia
ATCCCTGTCACGGGAA	Macrophages
ATCCGTCAGAATAGTC	Astrocytes
ATCCGTCAGAGGGTAA	ExciteL4
ATCCGTCAGCTGACCC	MOLs
ATCCGTCAGGTCCCTG	ExciteL6
ATCCGTCCAACTCGTA	MOLs
ATCCGTCCAGCCTATA	ExciteNP
ATCCGTCTCAGCTGAT	Microglia
ATCCGTCTCAGCTGTA	MOLs
ATCCGTCTCGACGCTG	ExciteL4
ATCCGTCTCTACACTT	MOLs
ATCCTATAGATGCGAC	ExciteL6
ATCCTATCACCAAAGG	COPs
ATCCTATGTAGTTCCA	Microglia
ATCCTATTCAGCAATC	MOLs
ATCCTATTCATTACGG	ExciteL23
ATCCTATTCTGAGGCC	MOLs
ATCCTATTCTTCTTCC	MOLs
ATCGATGAGACTTCGT	ExciteL4
ATCGATGAGGAGAATG	ExciteL23
ATCGATGCAGAGGTAC	ExciteL23
ATCGATGGTGGCGCTT	ExciteL5
ATCGATGGTTCTCCAC	MOLs
ATCGATGTCCATCAGA	COPs
ATCGATGTCCTGGGTG	ExciteL23
ATCGATGTCTGAATCG	Microglia
ATCGATGTCTTCACAT	Pericytes
ATCGCCTAGGATCACG	ExciteL4
ATCGCCTCAAGAATAC	Macrophages
ATCGCCTCACAGCCTG	Microglia
ATCGCCTCAGTCGAGA	ExciteL4
ATCGCCTCATCACCAA	OPCs
ATCGCCTGTCACTTAG	Ependymal
ATCGCCTGTCGCATCG	MOLs
ATCGCCTGTGTCCCTT	ExciteL4
ATCGCCTTCCAGTGCG	OPCs
ATCGGATAGGATACGC	Pericytes
ATCGGATAGTGTTCCA	Astrocytes
ATCGGATCACGGTAGA	MOLs
ATCGGATGTAGACAGC	COPs
ATCGGATTCCAGCAAT	NIPCs
ATCGTAGAGTCAAGCG	ExciteL23
ATCGTAGCAAAGACGC	Microglia
ATCGTAGCAATGGCAG	ExciteL4
ATCGTAGCAGACCGCT	Astrocytes
ATCGTAGGTACCGTGC	ExciteL6
ATCGTAGGTACCTAGT	MOLs
ATCGTAGGTACTCCGG	Microglia
ATCGTAGGTCCCTGTT	MOLs
ATCGTAGGTCGTACAT	Astrocytes
ATCGTCCAGACCTGGA	Astrocytes
ATCGTCCAGCATTTCG	Microglia
ATCGTCCAGTTGCTCA	OPCs
ATCGTCCGTAGAGATT	InhibNeuron
ATCGTCCGTATCGGTT	ExciteL4
ATCGTCCGTTACCTTT	OPCs
ATCGTCCTCGATTCCC	ExciteL6
ATCGTCCTCGCCATAA	ExciteL23
ATCGTCCTCTCGTCAC	NIPCs
ATCGTGACAACACAGG	Microglia
ATCGTGACAACGTATC	ExciteL23
ATCGTGACACCGTCGA	Microglia
ATCGTGACAGAATTCC	MOLs
ATCGTGACAGCGTGAA	ExciteL6
ATCGTGAGTACGCGTC	InhibNeuron
ATCGTGAGTAGACTGG	Astrocytes
ATCGTGAGTAGTTCCA	Endo
ATCGTGAGTCGAGCAA	Microglia
ATCGTGAGTCGGAACA	ExciteL5
ATCGTGATCTATTGTC	MOLs
ATCGTGATCTTGTGCC	Astrocytes
ATCTCTAAGAAGCTCG	OPCs
ATCTCTAAGATGGTAT	OPCs
ATCTCTAAGCCAAGCA	MOLs
ATCTCTAAGCCTCACG	ExciteL4
ATCTCTAAGTGGTTAA	InhibNeuron
ATCTCTACAACGTTAC	MOLs
ATCTCTAGTCTTGTCC	NIPCs
ATCTCTAGTGACGCCT	ExciteL4
ATCTCTAGTGAGTAAT	MOLs
ATCTCTATCACAATGC	InhibNeuron
ATCTCTATCGGAACTT	ExciteL6
ATCTCTATCTGGACTA	ExciteL23
ATCTTCACAACCACAT	ExciteL4
ATCTTCACAAGTAGTA	MOLs
ATCTTCAGTACCGGCT	COPs
ATCTTCAGTCACTTAG	ExciteL6
ATCTTCAGTTGCCATA	ExciteL4
ATCTTCATCATTTGGG	ExciteL6
ATGAAAGAGAAGGCTC	MOLs
ATGAAAGAGAGAAGGT	ExciteNP
ATGAAAGCACTCATAG	OPCs
ATGAAAGGTCAACACT	Microglia
ATGAAAGGTCATACCA	Astrocytes
ATGAAAGGTCGAACAG	ExciteL4
ATGAAAGGTGAGATAT	ExciteL5
ATGAAAGGTTAGAGAT	ExciteL6
ATGAAAGGTTGTTGCA	ExciteL4
ATGACCAAGGATAATC	Microglia
ATGACCAAGGGTACGT	Astrocytes
ATGACCACAAAGGGTC	ExciteL4
ATGACCACAGAGGCAT	ExciteL23
ATGACCACATCCTCAC	ExciteL6
ATGACCAGTTAGAGAT	Microglia
ATGACCATCAAATAGG	MOLs
ATGACCATCTATCACT	OPCs
ATGAGGGAGATCGACG	ExciteL4
ATGAGGGAGCTGTTAC	MOLs
ATGAGGGAGGTTCAGG	Microglia
ATGAGGGAGGTTCTAC	OPCs
ATGAGGGCACTGCTTC	ExciteL4
ATGAGGGGTCCGTACG	MOLs
ATGAGTCAGAAGGATG	ExciteL23
ATGAGTCAGCCTGCCA	ExciteL4
ATGAGTCCACATACTG	MOLs
ATGAGTCCAGCGACAA	ExciteL4
ATGAGTCGTACCGCGT	NIPCs
ATGAGTCGTACGTACT	MOLs
ATGAGTCGTATCGAAA	MOLs
ATGAGTCGTCACTACA	ExciteL5
ATGAGTCGTCCAGCCA	MOLs
ATGAGTCTCGTCCATC	Microglia
ATGAGTCTCTCGGGAC	ExciteL4
ATGATCGCACCGTCGA	ExciteL6
ATGATCGGTCTGTGTA	Microglia
ATGATCGTCTCCCATG	ExciteL6
ATGCATGAGCGATGGT	OPCs
ATGCATGCAAGAGTTA	Microglia
ATGCATGCATTAGGCT	Astrocytes
ATGCATGGTCATCGGC	MOLs
ATGCATGGTGGGTATG	Microglia
ATGCATGGTGTCCGGT	MOLs
ATGCATGGTTACGTAC	COPs
ATGCATGTCCTGCCAT	Pericytes
ATGCATGTCGCTGCGA	OPCs
ATGCCTCAGGATGCGT	ExciteL4
ATGCCTCAGGTCTACT	ExciteL4
ATGCCTCCAACATCGT	Pericytes
ATGCCTCCACTGCGTG	ExciteL23
ATGCCTCGTGGAGGTT	OPCs
ATGCCTCGTGGTCTTA	MOLs
ATGCCTCGTTACCCTC	Astrocytes
ATGCCTCGTTCGGACC	MOLs
ATGCCTCGTTTGATCG	ExciteL23
ATGCGATAGCCGTAAG	ExciteL5
ATGCGATCACTGGAAG	Microglia
ATGCGATCAGGAGGTT	Microglia
ATGCGATCAGTAGTTC	ExciteL23
ATGCGATCAGTATGAA	OPCs
ATGCGATCATCCCACT	Microglia
ATGCGATGTCAAGCCC	OPCs
ATGCGATGTCCTTTGC	Microglia
ATGCGATTCGTCGACG	OPCs
ATGCGATTCTCAGTCC	MOLs
ATGCGATTCTGTAACG	MOLs
ATGGAGGAGAACGCGT	ExciteL4
ATGGAGGGTCTGTGAT	Endo
ATGGAGGTCATGTCTT	Microglia
ATGGAGGTCCCGTGTT	Microglia
ATGGAGGTCTGGAAGG	NIPCs
ATGGATCAGAGTCTGG	COPs
ATGGATCAGGCACTCC	Microglia
ATGGATCCACCAGCGT	OPCs
ATGGATCCATGTAACC	ExciteL4
ATGGATCGTAACGTTC	Microglia
ATGGATCGTACATACC	OPCs
ATGGATCGTGATGAAT	OPCs
ATGGATCGTGATTCTG	ExciteL4
ATGGATCGTTGGAGAC	MOLs
ATGGATCGTTGTACGT	MOLs
ATGGATCTCGTCTCAC	ExciteL23
ATGGGAGAGCTGACCC	ExciteL6
ATGGGAGAGTCAGAGC	ExciteNP
ATGGGAGCACGGTGCT	ExciteL4
ATGGGAGCACTCCACT	ExciteL4
ATGGGAGCAGAGCTAG	MOLs
ATGGGAGCAGTAACCT	COPs
ATGGGAGGTGGCAACA	InhibNeuron
ATGGGAGGTGTTTCTT	ExciteL4
ATGGGAGGTTGGGCCT	ExciteL23
ATGGGTTAGAGTCACG	ExciteL4
ATGGGTTAGTCTCGTA	ExciteL4
ATGGGTTCAACCCGCA	Microglia
ATGGGTTCACAAAGCG	Macrophages
ATGGGTTCAGCAGTTT	Astrocytes
ATGGGTTCAGGAATCG	ExciteL6
ATGGGTTCATCGGAAG	ExciteL4
ATGGGTTGTGTTCAGT	ExciteL4
ATGGGTTGTTAAGGGC	COPs
ATGGGTTTCCCAACTC	Astrocytes
ATGGGTTTCCGAGAAG	MOLs
ATGGGTTTCGTCGGGT	Microglia
ATGGTTGCATACCACA	ExciteL6
ATGGTTGCATGGTACT	Astrocytes
ATGGTTGTCGAATCCA	ExciteL4
ATGTCCCAGGCTAACG	MOLs
ATGTCCCAGTAGGAAG	Microglia
ATGTCCCCACAAAGCG	Pericytes
ATGTCCCCACCTGTCT	COPs
ATGTCCCGTTGAATCC	ExciteL4
ATGTCTTAGACCAAAT	MOLs
ATGTCTTAGACTACGG	Astrocytes
ATGTCTTCAATCGCAT	MOLs
ATGTCTTCACCCTATC	InhibNeuron
ATGTCTTCAGCACAGA	ExciteL4
ATGTCTTCAGGCTCTG	Astrocytes
ATGTCTTGTAGCCAGA	ExciteL5
ATGTCTTGTCTCACGG	Microglia
ATGTCTTGTGGTCTGC	MOLs
ATGTCTTTCAACTACG	ExciteL4
ATTACCTAGACCTCCG	MOLs
ATTACCTAGGTCACTT	MOLs
ATTACCTCAAAGTGTA	ExciteL6
ATTACCTCAATACCTG	Pericytes
ATTACCTCAATGGCCC	ExciteL4
ATTACCTCACGGGCTT	MOLs
ATTACCTCAGGTGTTT	InhibNeuron
ATTACCTCATCTCATT	ExciteL6
ATTACCTGTCCAAAGG	Astrocytes
ATTACCTGTGTCTTGA	ExciteL4
ATTACCTTCTTCGACC	Pericytes
ATTACTCAGCAGCCTC	ExciteL4
ATTACTCAGCTCGCAC	ExciteL23
ATTACTCCAGTCGCAC	Microglia
ATTACTCCAGTTTCAG	Microglia
ATTACTCTCACATTGG	MOLs
ATTACTCTCAGGACGA	InhibNeuron
ATTACTCTCGCTGCGA	ExciteNP
ATTATCCCAAGAAATC	OPCs
ATTATCCCAATGCTCA	OPCs
ATTATCCCATCGCTAA	ExciteL5
ATTATCCGTACGCTAT	Microglia
ATTATCCGTCCGAAGA	ExciteL4
ATTATCCTCAACTGGT	ExciteL4
ATTATCCTCCCGTTGT	Endo
ATTATCCTCGTAGGAG	Astrocytes
ATTCACTAGCGACTTT	NIPCs
ATTCACTAGCGATTCT	Microglia
ATTCACTAGTCTCTGA	COPs
ATTCACTAGTTGTAGA	Astrocytes
ATTCACTCACTACAGT	InhCajalRetzius
ATTCACTCAGCTGAAG	ExciteL5
ATTCACTCATGCAGCC	ExciteL4
ATTCACTGTACCGGAA	MOLs
ATTCACTGTACTCGAT	OPCs
ATTCACTTCGAGATAA	InhibNeuron
ATTCACTTCTTCCTAA	COPs
ATTCACTTCTTCTGTA	Astrocytes
ATTCAGGAGCTGCCTG	MOLs
ATTCAGGGTACTTGTG	ExciteL23
ATTCAGGGTCGGTAAG	ExciteL6
ATTCAGGGTGGACTGA	Astrocytes
ATTCAGGGTGTCCATA	Microglia
ATTCAGGTCACGGTCG	ExciteL23
ATTCAGGTCTACGCGG	OPCs
ATTCATCAGGCATTTC	Microglia
ATTCATCGTTCAAAGA	Microglia
ATTCATCTCGTTGTAG	MOLs
ATTCCATAGCTATCCA	Endo
ATTCCATCATACACCA	Microglia
ATTCCATGTCTTGGTA	Microglia
ATTCCATTCTTTGCTA	ExciteL4
ATTCCCGCAACAAGAT	ExciteL6
ATTCCCGCAGAACTTC	COPs
ATTCCCGCATCCTGTC	ExciteL6
ATTCCCGGTACCTAGT	ExciteL4
ATTCCCGGTCTAACGT	OPCs
ATTCCCGGTCTCAGAT	InhibNeuron
ATTCCCGGTTGCCATA	ExciteL4
ATTCCCGTCGAGTCCG	Microglia
ATTCCTAAGGAGTATT	OPCs
ATTCCTACAAGCAATA	OPCs
ATTCCTAGTGATACCT	Pericytes
ATTCCTATCAACCGAT	ExciteL6
ATTCCTATCGTGGGTC	ExciteL4
ATTCGTTAGGCCGCTT	Astrocytes
ATTCGTTCACCTTCGT	ExciteL5
ATTCGTTCATCCTATT	ExciteL4
ATTCGTTCATCTCAAG	ExciteL4
ATTCGTTCATTGAAGA	COPs
ATTCGTTCATTGAGCT	ExciteL4
ATTCGTTGTACTCAAC	ExciteL6
ATTCGTTGTATATGGA	ExciteL5
ATTCGTTTCATCGACA	Microglia
ATTCGTTTCCATTGTT	Pericytes
ATTCTACAGCACTCTA	MOLs
ATTCTACAGGATACGC	MOLs
ATTCTACAGTAGACAT	Astrocytes
ATTCTACCATCTCAAG	ExciteL6
ATTCTACGTCATCGCG	Microglia
ATTCTACGTCTCGACG	ExciteL23
ATTCTACGTTCCTAGA	Microglia
ATTCTACGTTCGGTAT	OPCs
ATTCTACGTTGCCAAT	Astrocytes
ATTCTACGTTTGGGTT	OPCs
ATTCTACTCAAGTTGC	Microglia
ATTCTACTCATGCATG	ExciteL4
ATTCTACTCATGTCTT	ExciteL4
ATTCTTGAGAGAGCCT	Astrocytes
ATTCTTGAGATAGCAT	MOLs
ATTCTTGCAGTCGGTC	Microglia
ATTCTTGGTCACCACG	Astrocytes
ATTCTTGGTGACTGAG	OPCs
ATTCTTGTCCAGCACG	ExciteL4
ATTCTTGTCGCAATTG	InhibNeuron
ATTGGGTAGGAAGTAG	ExciteL6
ATTGGGTAGGACATCG	ExciteL4
ATTGGGTAGTACTGTC	ExciteL4
ATTGGGTCATCCAATG	Astrocytes
ATTGGGTGTACGACAG	OPCs
ATTGGGTGTTAGGAGC	Macrophages
ATTGGGTGTTCTCCTG	ExciteL4
ATTGGGTTCGCTGATA	Microglia
ATTGTTCAGACACACG	Microglia
ATTGTTCAGAGTTCGG	Microglia
ATTGTTCAGATGCCGA	ExciteL6
ATTGTTCAGCAGTAAT	OPCs
ATTGTTCAGCAGTCTT	ExciteL23
ATTGTTCCAAGGATGC	Pericytes
ATTGTTCGTACCCACG	OPCs
ATTGTTCGTCAACCAT	MOLs
ATTGTTCGTCACTGAT	ExciteL23
ATTGTTCGTCTCAGGC	NIPCs
ATTGTTCGTGAGTTGG	ExciteL6
ATTGTTCTCGGAGTAG	MOLs
ATTTACCAGTCCGCCA	Astrocytes
ATTTACCCATTGACAC	Astrocytes
ATTTACCGTAAGTTGA	ExciteL4
ATTTACCGTAGCACGA	Astrocytes
ATTTACCTCACGGGCT	InhibNeuron
ATTTACCTCTAGATCG	Macrophages
ATTTACCTCTAGCCAA	Microglia
ATTTCACAGCGAGTAC	MOLs
ATTTCACAGCGTGCCT	ExciteL5
ATTTCACCATCCGGCA	ExciteNP
ATTTCACCATTGACCA	Microglia
ATTTCACGTAGATCGG	Microglia
ATTTCACGTCGCACGT	ExciteL23
ATTTCACGTTGCATGT	MOLs
ATTTCACTCCAAACCA	Microglia
ATTTCACTCTAACGGT	ExciteL4
ATTTCACTCTTTGGAG	ExciteL23
ATTTCTGCATCCTGTC	ExciteL6
ATTTCTGTCACGGACC	Astrocytes
ATTTCTGTCCAGCCTT	MOLs
CAAAGAACACAATGCT	Pericytes
CAAAGAACAGTAGAGC	ExciteL4
CAACAACAGCCTTTGA	Microglia
CAACAACCAAACCATC	ExciteNP
CAACAACCATATACCG	Macrophages
CAACAACGTAGGTACG	Astrocytes
CAACAACGTCTGCAAT	MOLs
CAACAACGTTGAGTCT	OPCs
CAACAACTCGAAGGAC	ExciteL6
CAACAGTAGCGCTGCT	ExciteL5
CAACAGTCAGATCCTA	ExciteL4
CAACAGTGTACTTGTG	COPs
CAACAGTGTCGGTGAA	COPs
CAACAGTTCCGGTTCT	ExciteL4
CAACCAAAGACCGTTT	ExciteL6
CAACCAAAGACGTCGA	ExciteNP
CAACCAAAGAGTGTGC	ExciteL6
CAACCAAAGATGGTCG	ExciteNP
CAACCAAAGCTCAGAG	COPs
CAACCAACAGAGCTAG	Microglia
CAACCAACATTCCTCG	MOLs
CAACCAAGTCGACTTA	ExciteNP
CAACCAAGTCTGTTAG	ExciteL23
CAACCAAGTGGGAGAG	Microglia
CAACCAATCGTAACAC	Microglia
CAACCAATCTCTCGCA	ExciteNP
CAACCTCAGAAGTCCG	Microglia
CAACCTCAGATAGCTA	MOLs
CAACCTCAGGAAACGA	OPCs
CAACCTCCAGATCATC	InhibNeuron
CAACCTCCAGTTCACA	InhibNeuron
CAACCTCGTGAGTTGG	ExciteL6
CAACCTCGTTACGGAG	Microglia
CAACCTCTCGTTGTGA	ExciteL4
CAACCTCTCTTACGTT	MOLs
CAACGATCAGTTAGAA	ExciteL4
CAACGATGTCACTTCC	COPs
CAACGGCCACACGGAA	ExciteL6
CAACGGCCACCATATG	Microglia
CAACGGCCACCGTGGT	ExciteL4
CAACGGCTCCACATAG	Astrocytes
CAACGGCTCTATACGG	ExciteL23
CAACGGCTCTGTAACG	OPCs
CAAGACTAGCGAGAAA	ExciteNP
CAAGACTAGCTGGTGA	MOLs
CAAGACTAGTAAACAC	ExciteL23
CAAGACTAGTAACCGG	Astrocytes
CAAGACTCACAAGTGG	Microglia
CAAGACTGTCGGCACT	ExciteL23
CAAGACTGTCTGTGAT	ExciteL4
CAAGACTTCTGTCCGT	OPCs
CAAGACTTCTTTGCTA	ExciteL6
CAAGAGGAGATAGCAT	ExciteL4
CAAGAGGAGCCGATCC	Microglia
CAAGAGGAGGTTCACT	MOLs
CAAGAGGCAAATCAGA	MOLs
CAAGAGGCATGGGCAA	MOLs
CAAGAGGGTATTGCCA	Microglia
CAAGAGGGTCCGACGT	ExciteL6
CAAGAGGGTCTAGATC	ExciteL6
CAAGAGGGTGACTATC	Astrocytes
CAAGAGGGTGATGTAA	Astrocytes
CAAGAGGGTTCAGCTA	Microglia
CAAGAGGTCTTTGATC	Microglia
CAAGCTAAGTGAGTGC	OPCs
CAAGCTACACCAACAT	MOLs
CAAGCTACAGGTTTAC	ExciteL23
CAAGCTAGTATCGTGT	ExciteL4
CAAGCTAGTCGAGATG	ExciteL4
CAAGCTAGTGGAAGTC	Astrocytes
CAAGCTATCTCCATAT	MOLs
CAAGGGAAGCAGTCTT	COPs
CAAGGGAAGGGCCCTT	ExciteL6
CAAGGGAAGGGCGAGA	ExciteL23
CAAGGGAAGGTTATAG	ExciteL5
CAAGGGACACCTCAGG	Microglia
CAAGGGACACTTGTCC	ExciteL23
CAAGGGACAGAAATCA	Astrocytes
CAAGGGACAGAGTTGG	MOLs
CAAGGGACAGCACAGA	ExciteNP
CAAGGGACATGGCACC	Microglia
CAATACGAGAAATGGG	Astrocytes
CAATACGAGACCAAAT	MOLs
CAATACGCACCGTCGA	MOLs
CAATACGCACCGTGGT	MOLs
CAATACGGTATTGACC	ExciteL23
CAATACGTCAGGACGA	Astrocytes
CAATACGTCCCGATCT	Microglia
CAATACGTCCGTACGG	Microglia
CAATACGTCGCTCTCA	Microglia
CAATCGAAGTGGAATT	Microglia
CAATCGACAGCTAACT	OPCs
CAATCGAGTAGGATAT	Astrocytes
CAATCGAGTATCGATC	MOLs
CAATCGAGTCTTGAAC	ExciteL23
CAATCGAGTGGCTTAT	OPCs
CAATCGAGTGTGTCGC	ExciteL6
CAATCGATCATGTCAG	Astrocytes
CAATCGATCGCTAAAC	COPs
CAATCGATCTCAACGA	Astrocytes
CAATCGATCTCATTGT	Microglia
CAATGACAGCACTCAT	ExciteL23
CAATGACAGGAACTAT	Astrocytes
CAATGACAGGTCGTGA	COPs
CAATGACCATCCGTTC	Microglia
CAATGACGTCTACAGT	MOLs
CAATGACTCGGTCGGT	ExciteL5
CAATGACTCTTACACT	Ependymal
CAATTTCAGCCGAATG	ExciteL4
CAATTTCAGCGTTAGG	ExciteNP
CAATTTCAGTAAGCAT	InhibNeuron
CAATTTCCACAGCCAC	Microglia
CAATTTCGTATGTCCA	MOLs
CAATTTCTCAGTCACA	Microglia
CACAACAAGTTACTCG	MOLs
CACAACACAGAGGTAC	ExciteL4
CACAACAGTCATCACA	InhibNeuron
CACAACAGTGACCGAA	Endo
CACAACAGTTAAGGGC	Microglia
CACAACATCACTTGTT	ExciteL4
CACAACATCCGGACGT	Microglia
CACAACATCGCGTGAC	Microglia
CACAACATCTAGTGTG	ExciteL4
CACACAACACCGTACG	Microglia
CACACAAGTATAGCTC	OPCs
CACACAATCCTACAAG	MOLs
CACAGATAGAATTGTG	OPCs
CACAGATAGACGGTTG	ExciteL5
CACAGATAGAGAGTTT	COPs
CACAGATAGCGGATCA	Microglia
CACAGATAGTACTGTC	MOLs
CACAGATCAATCTCGA	ExciteL4
CACAGATCATTGGATC	OPCs
CACAGATGTCTCTCAC	ExciteL4
CACAGATGTGAGTTTC	OPCs
CACAGATTCACTACTT	ExciteL23
CACAGGCAGACTTCAC	Astrocytes
CACAGGCAGCAGATAT	OPCs
CACAGGCCATAGGAGC	Astrocytes
CACAGGCGTAACCAGG	ExciteL4
CACAGGCGTGGGTCAA	Astrocytes
CACAGGCTCGGTCAGC	ExciteL5
CACAGGCTCTAAGCCA	MOLs
CACAGGCTCTGTGCGG	Microglia
CACATGAAGCCTAACT	Astrocytes
CACATGAAGTAACCGG	OPCs
CACATGAAGTCATCGT	Microglia
CACATGACAGCATCTA	Microglia
CACATGACATCGCTCT	ExciteL4
CACATGACATGGGCAA	MOLs
CACATGATCACCTTGC	Astrocytes
CACATGATCGTGTGAT	Astrocytes
CACCAAAAGAGAGCCT	Endo
CACCAAACATCTATCT	InhibNeuron
CACCAAACATTGCTTT	MOLs
CACCAAAGTAACAGGC	InhibNeuron
CACCAAAGTAAGTAGT	OPCs
CACCAAAGTCTAATCG	ExciteL23
CACCAAAGTGCCGTAC	Microglia
CACCAAATCCTCGCAT	Astrocytes
CACCAAATCGCTACAA	ExciteL6
CACCAAATCTAGACAC	Microglia
CACCGTTAGAAACCCG	MOLs
CACCGTTAGAGTGTTA	ExciteL4
CACCGTTAGCGATCGA	MOLs
CACCGTTAGCTAAACA	ExciteL4
CACCGTTAGGTAAAGG	ExciteL4
CACCGTTAGGTATTGA	Astrocytes
CACCGTTCACAATGCT	Microglia
CACCGTTCATTCCTCG	OPCs
CACCGTTGTCGTGATT	Microglia
CACCGTTGTCTCTCCA	Astrocytes
CACCGTTGTCTTACAG	InhibNeuron
CACCGTTGTTAAACAG	Microglia
CACCGTTTCGATACAC	OPCs
CACCGTTTCTCTGCTG	MOLs
CACGAATAGACTAGAT	OPCs
CACGAATAGAGTCCGA	ExciteL4
CACGAATAGCTGCGAA	ExciteL23
CACGAATCAAATGCTC	NIPCs
CACGAATGTAACATAG	InhibNeuron
CACGAATTCACAAGGG	MOLs
CACGAATTCGCTAGCG	Fibroblasts
CACGGGTAGGATGCGT	ExciteNP
CACGGGTCAAATAGCA	MOLs
CACGGGTCAAGACCGA	ExciteL6
CACGGGTCAAGTGGCA	Microglia
CACGGGTCACAACGCC	Microglia
CACGGGTCAGCGTGAA	Microglia
CACGGGTGTGGAACAC	ExciteL5
CACGGGTGTGTTCAGT	OPCs
CACGGGTTCAAGAGTA	Astrocytes
CACGGGTTCAGAGTTC	Microglia
CACGGGTTCCACGGGT	ExciteL23
CACGGGTTCTGCTTAT	ExciteL4
CACGTGGGTTCAGTAC	ExciteL6
CACGTTCCAATCACGT	Astrocytes
CACGTTCCAGTGTATC	Microglia
CACGTTCGTAGGGTAC	ExciteL4
CACGTTCGTTGGACCC	Microglia
CACGTTCTCTCTCTTC	Microglia
CACTAAGAGATGAATC	OPCs
CACTAAGAGCCGTCGT	ExciteL4
CACTAAGAGGAACGAA	Astrocytes
CACTAAGAGTCATGAA	Microglia
CACTAAGGTTGAATCC	Microglia
CACTAAGTCAAGCTGT	Microglia
CACTAAGTCAGGGTAG	Astrocytes
CACTAAGTCCGTCACT	ExciteL4
CACTAAGTCCGTTTCG	MOLs
CACTAAGTCTTTGCAT	ExciteL4
CACTGAAAGCAGGGAG	MOLs
CACTGAAAGCTAGATA	OPCs
CACTGAACACACTGGC	Microglia
CACTGAACACCAAAGG	Astrocytes
CACTGAAGTCAGCGTC	ExciteL4
CACTGAAGTCATTCCC	ExciteL5
CACTGAAGTCCGGATC	ExciteL23
CACTGAAGTGAGATTA	MOLs
CACTGAATCATCGCCT	MOLs
CACTGAATCCTACGGG	ExciteNP
CACTGGGCACAGCGCT	MOLs
CACTGGGCATTCAGGT	OPCs
CACTGGGGTAGACAAT	MOLs
CACTGGGGTCACAGTT	ExciteL6
CACTGGGGTCAGACTT	COPs
CACTGGGGTGCAATAA	ExciteL4
CACTGGGGTGGACCTC	Astrocytes
CACTGGGGTTGGACCC	Microglia
CACTGGGTCACTGTCC	OPCs
CACTGTCAGCCGAATG	Microglia
CACTGTCCATGCGTGC	InhibNeuron
CACTGTCGTCCACACG	ExciteL6
CACTGTCGTCCTGGTG	Microglia
CACTGTCGTTGGTACT	OPCs
CACTGTCTCCGCTGTT	ExciteNP
CACTGTCTCCTGTTGC	ExciteL23
CACTGTCTCGAATGCT	MOLs
CACTGTCTCTGAGAAA	ExciteL6
CACTTCGAGCTAGATA	Astrocytes
CACTTCGCACCTCGTT	Astrocytes
CACTTCGCAGAAATCA	ExciteL4
CACTTCGCAGATCATC	Astrocytes
CACTTCGTCGAGCTGC	MOLs
CAGAGCCAGACGCTCC	Microglia
CAGAGCCAGATGTTCC	OPCs
CAGAGCCGTCCATACA	OPCs
CAGAGCCGTTCTAAGC	ExciteL4
CAGAGCCGTTTGTTGG	ExciteL6
CAGAGCCTCAAGTCTG	Astrocytes
CAGAGCCTCTCTCGAC	Microglia
CAGATACAGCGTCAGA	Microglia
CAGATACAGTGAATAC	ExciteL6
CAGATACCAAGGTTGG	ExciteL6
CAGATACCACCTCAGG	Macrophages
CAGATACCAGCATGCC	Microglia
CAGATACCATTCTGTT	MOLs
CAGATACGTTCTCAGA	OPCs
CAGATACGTTTAAGGA	MOLs
CAGATACTCAGACAAA	ExciteL23
CAGATACTCCTAGCTC	Microglia
CAGATACTCTGCGTCT	Microglia
CAGATCAAGGGTAATT	Astrocytes
CAGATCACATGAAGCG	Pericytes
CAGATCAGTCCCGGTA	Astrocytes
CAGATCATCATGGGAG	ExciteL23
CAGATCATCCGAGTGC	MOLs
CAGATCATCCGTGCGA	OPCs
CAGATTGAGCTGGCCT	NIPCs
CAGATTGCAAGCGAAC	ExciteL6
CAGATTGGTCCTGGGT	Microglia
CAGATTGTCAATCGGT	ExciteNP
CAGATTGTCACTAGCA	ExciteL4
CAGATTGTCGAAGAAT	OPCs
CAGATTGTCTTCTAAC	ExciteL6
CAGCAATAGTAAGACT	Microglia
CAGCAATCAACCCTCT	InhibNeuron
CAGCAATCAAGGGTCA	OPCs
CAGCAATCAATTGCAC	Microglia
CAGCAATCAGAAGTTA	ExciteL4
CAGCAATCATGGCCAC	ExciteL4
CAGCAATTCAAGTGTC	OPCs
CAGCAATTCTCACTCG	Astrocytes
CAGCACGAGAGGATGA	MOLs
CAGCACGAGGAGAATG	ExciteL4
CAGCACGAGTTTCGGT	ExciteNP
CAGCACGCAAACACCT	Ependymal
CAGCACGCAACCGGAA	Microglia
CAGCACGCACATAGCT	Microglia
CAGCACGCACCACATA	Microglia
CAGCACGCATCCTATT	Microglia
CAGCACGGTCAGGAGT	OPCs
CAGCACGGTCCACGCA	InhibNeuron
CAGCACGTCGTCTCAC	ExciteL6
CAGCACGTCTATCGCC	OPCs
CAGCAGCAGTCTCGTA	OPCs
CAGCAGCCAAGTGCTT	Microglia
CAGCAGCCAATACGAA	ExciteL6
CAGCAGCCATGCACTA	Microglia
CAGCAGCGTAGGTAGC	Astrocytes
CAGCAGCGTATCGATC	Microglia
CAGCAGCTCAACCCGG	Microglia
CAGCAGCTCCACAGCG	InhibNeuron
CAGCCAGCAACAGCTT	ExciteL4
CAGCCAGCAGTGCGCT	Astrocytes
CAGCCAGGTACGGGAT	Microglia
CAGCCAGTCATGACAC	Astrocytes
CAGCCAGTCCAAGCAT	OPCs
CAGCCAGTCGCCGATG	Astrocytes
CAGCGTGAGGCGCTCT	Astrocytes
CAGCGTGAGTGTACCT	ExciteL23
CAGCGTGCAGTTAGGG	ExciteL6
CAGCGTGTCACGGGAA	Astrocytes
CAGCGTGTCGGAAACG	MOLs
CAGCGTGTCGTGTGAT	MOLs
CAGGCCAAGCCTTGAT	Microglia
CAGGCCACAGCAGAAC	Astrocytes
CAGGCCAGTATGAAGT	MOLs
CAGGCCAGTGGCTAGA	Microglia
CAGGCCATCCGGCTTT	OPCs
CAGGCCATCGCATGAT	Microglia
CAGGGCTAGCAGCACA	Microglia
CAGGGCTCACGTAGAG	OPCs
CAGGGCTGTCGTGTTA	MOLs
CAGGGCTTCAAGCCAT	Astrocytes
CAGGTATCACACAGCC	MOLs
CAGGTATGTATCACGT	Ependymal
CAGGTATGTCCGGCAT	Microglia
CAGGTATGTTTCGTTT	Pericytes
CAGGTATTCACCTGTC	ExciteL4
CAGGTATTCGCGATCG	Microglia
CAGGTATTCTGGCCGA	ExciteNP
CAGTGCGAGACCATGG	ExciteL6
CAGTGCGAGACCGTTT	OPCs
CAGTGCGAGGTTCAGG	ExciteL23
CAGTGCGCACCGAATT	Astrocytes
CAGTGCGCACTGGCGT	ExciteL4
CAGTGCGCAGACTCTA	OPCs
CAGTGCGCAGGAGGAG	ExciteL6
CAGTGCGGTAAGTTGA	Astrocytes
CAGTGCGGTACTGACT	ExciteL4
CAGTGCGTCAATCTCT	ExciteL6
CAGTGCGTCACCACAA	Microglia
CAGTGCGTCCTGTTGC	COPs
CAGTGCGTCTTAATCC	COPs
CAGTTAGAGACGGTTG	NIPCs
CAGTTAGAGCTAAATG	ExciteL5
CAGTTAGCAAAGTATG	InhibNeuron
CAGTTAGCAGGTTCAT	Microglia
CAGTTAGCAGTTCTAG	Macrophages
CAGTTAGGTCATCACA	ExciteL5
CAGTTAGGTCATCAGT	Microglia
CAGTTAGGTGCCTGCA	ExciteL6
CAGTTAGGTTGCGGCT	ExciteL4
CAGTTAGTCGTCAACA	ExciteL6
CAGTTAGTCTCATTTG	ExciteNP
CAGTTCCAGTGCACAG	Astrocytes
CAGTTCCCACGGAAGT	ExciteL5
CAGTTCCCAGCGCGTT	Microglia
CAGTTCCGTAATCAGA	Microglia
CAGTTCCGTAGCCAGA	OPCs
CAGTTCCTCAAGTAAG	Astrocytes
CAGTTCCTCCTCACCA	Microglia
CAGTTCCTCTAGTGTG	ExciteL4
CATAAGCCATAATGCC	ExciteL4
CATAAGCTCCCGTTGT	MOLs
CATAAGCTCTGCAGCG	MOLs
CATACAGAGGCTTCCG	MOLs
CATACAGAGTGGTGAC	Astrocytes
CATACAGCAATCGTCA	Microglia
CATACAGCACTTCTCG	MOLs
CATACAGCATGTAACC	Microglia
CATACAGGTAAGGTCG	Endo
CATACAGGTTAAGAAC	ExciteL6
CATACAGTCAACTGAC	Astrocytes
CATACAGTCGCTTGCT	MOLs
CATACAGTCTGCCTGT	COPs
CATACCCAGCAAGTGC	COPs
CATACCCGTAGTAAGT	OPCs
CATACCCGTGTTGCCG	ExciteL6
CATACCCGTTCGGCTG	MOLs
CATACCCTCAGCCTCT	MOLs
CATACCCTCGCCGATG	MOLs
CATACTTAGTTGCTGT	Microglia
CATACTTCAACCAGAG	Microglia
CATACTTGTAACGCGA	ExciteL23
CATAGACCAGCTATAC	OPCs
CATAGACTCCCAACTC	ExciteL6
CATAGACTCCTGTACC	COPs
CATAGACTCTTCCCGA	Microglia
CATCAAGAGGAAAGTG	ExciteL23
CATCAAGAGGGCATGT	Endo
CATCAAGAGGTCGTGA	InhibNeuron
CATCAAGCAGATTAAG	InhibNeuron
CATCAAGGTCATCGCG	Microglia
CATCAAGTCCCGAATA	InhibNeuron
CATCAAGTCGACATTG	Microglia
CATCAAGTCGGCCAAC	ExciteL5
CATCCACAGCACTAAA	ExciteL23
CATCCACAGCATATGA	MOLs
CATCCACAGGAGTCTG	ExciteL4
CATCCACAGTGCAAAT	ExciteL6
CATCCACGTACTCCGG	ExciteL6
CATCCCAAGCAGGCAT	COPs
CATCCCAAGCGGGTAT	Microglia
CATCCCACAAGAGTTA	Astrocytes
CATCCCAGTTCAGTAC	ExciteL6
CATCCCAGTTCTCAGA	Astrocytes
CATCCCATCGTAATGC	Microglia
CATCCGTCATGTAACC	MOLs
CATCCGTGTACGGGAT	ExciteL5
CATCCGTGTCTTGAGT	MOLs
CATCCGTTCCATTCAT	Astrocytes
CATCCGTTCTGTACAG	ExciteL4
CATCGCTAGCTGCGAA	MOLs
CATCGCTCAAATGAAC	ExciteL4
CATCGCTCAGCAGACA	NIPCs
CATCGCTTCGCCACTT	MOLs
CATCGGGAGACGTCCC	COPs
CATCGGGCAATGACCT	InhibNeuron
CATCGGGGTCTTGCGG	ExciteL23
CATCGGGTCGAAGTGG	ExciteL4
CATCGTCAGTGACACG	ExciteL5
CATCGTCCAAAGGGTC	MOLs
CATCGTCCAGGTCTCG	Microglia
CATCGTCCATAACAGA	ExciteL4
CATCGTCCATGGAAGC	ExciteNP
CATCGTCGTAGTTACC	OPCs
CATCGTCGTATGCGGA	NIPCs
CATCGTCTCGGACTGC	OPCs
CATGAGTAGAAGAACG	OPCs
CATGAGTCAGAAACCG	ExciteL23
CATGAGTGTATTGCCA	ExciteL6
CATGAGTGTGTTGAGG	Microglia
CATGAGTGTTTACCAG	OPCs
CATGAGTGTTTGAACC	MOLs
CATGAGTTCATGCGGC	Astrocytes
CATGAGTTCCCATTTA	Pericytes
CATGCAAAGCATTGTC	Microglia
CATGCAACAAGCACCC	ExciteL6
CATGCAACAAGCTCTA	Microglia
CATGCAACACTCCGAG	Microglia
CATGCAACAGGAACCA	Astrocytes
CATGCAACATCGAAGG	MOLs
CATGCAAGTAACACGG	MOLs
CATGCAAGTATGCGGA	Microglia
CATGCAATCCGTGGGT	OPCs
CATGCAATCGTGACTA	ExciteL23
CATGCAATCTTTGGAG	OPCs
CATGCCTAGACTCGAG	Microglia
CATGCCTAGAGAGCAA	Astrocytes
CATGCCTAGGTCTGGA	MOLs
CATGCCTAGTGATCGG	OPCs
CATGCCTAGTTACGTC	COPs
CATGCCTCATAGAGGC	ExciteL6
CATGCCTGTCTTGTCC	InhibNeuron
CATGCCTTCTCTGGTC	OPCs
CATGCGGAGCTCGACC	ExciteL4
CATGCGGAGTAGCCAG	InhibNeuron
CATGCGGAGTCCGCGT	InhibNeuron
CATGCGGAGTTTAGGA	ExciteL23
CATGCGGCACAAAGTA	ExciteL4
CATGCGGCACCAGGTC	ExciteL4
CATGCGGGTAGCGTAG	ExciteL6
CATGCTCAGAGCCTGA	OPCs
CATGCTCCAACCAACT	MOLs
CATGCTCCACGTCGTG	ExciteL4
CATGCTCCATTCAGGT	Microglia
CATGCTCTCCGTTTCG	MOLs
CATGGATAGAGCAACC	MOLs
CATGGATCAGCGCTTG	Astrocytes
CATGGATCAGTGGTGA	Astrocytes
CATGGATGTGAGATCG	Microglia
CATGGATTCGCCACTT	ExciteL4
CATGGTAAGTTGGCGA	NIPCs
CATGGTACAAACGAGC	ExciteL6
CATGGTACAAGATTGA	ExciteL6
CATGGTACATCAACCA	ExciteL5
CATGGTAGTAGATCCT	Astrocytes
CATGGTAGTTTCAGAC	MOLs
CATGGTATCCGAAATC	ExciteL4
CATGGTATCTAGAGCT	ExciteL6
CATGGTATCTGGCCAG	Microglia
CATTCATAGATACATG	ExciteL23
CATTCATAGTAGGGTC	Microglia
CATTCATCAGCGTTTA	MOLs
CATTCATGTGAGAGGG	Microglia
CATTCATGTTCTTGTT	Astrocytes
CATTCCGAGTGCCTCG	Microglia
CATTCCGCACCCTAAA	ExciteL4
CATTCCGTCCAGGACC	Microglia
CATTCCGTCCGGTAAT	Microglia
CATTCCGTCGCTCTAC	OPCs
CATTCCGTCGGACTTA	ExciteL4
CATTCTAAGCTATCCA	OPCs
CATTCTAAGCTGTTAC	InhibNeuron
CATTCTAAGTGGATAT	NIPCs
CATTCTACAAACTAAG	OPCs
CATTCTACAACACGTT	COPs
CATTCTACAGACGGAT	InhibNeuron
CATTCTACAGTATTCG	InhibNeuron
CATTCTACATATCTGG	Microglia
CATTCTACATGGACAG	ExciteL6
CATTCTAGTAACCCGC	MOLs
CATTCTAGTACAGTCT	InhibNeuron
CATTCTAGTACGATGG	ExciteL23
CATTCTAGTGGAAGTC	InhibNeuron
CATTCTATCACCCTTG	ExciteL4
CATTCTATCCTTTAGT	Endo
CATTCTATCTGCGGGT	OPCs
CATTGAGAGCAATAGT	ExciteL6
CATTGAGAGTAAATGC	Astrocytes
CATTGAGCACGACCTG	InhibNeuron
CATTGAGCACGAGAAC	Fibroblasts
CATTGAGCATGACTCA	MOLs
CATTGAGGTGCCGGTT	ExciteL23
CATTGAGGTTCGGCCA	OPCs
CATTGAGGTTCTATCT	ExciteL4
CATTGAGTCAATCCAG	ExciteL4
CATTGAGTCCCGATCT	ExciteL4
CATTGAGTCCTCACCA	Microglia
CATTGCCAGCAGTACG	ExciteL4
CATTGCCAGCGGGTAT	Astrocytes
CATTGCCAGTACTGTC	MOLs
CATTGCCCAACCAATC	NIPCs
CATTGCCCACTTCCTG	NIPCs
CATTGCCCAGCACAAG	ExciteL4
CATTGCCCATCAGCAT	MOLs
CATTGCCCATCCTATT	Microglia
CATTGCCGTAGAGATT	ExciteL6
CATTGCCTCCCGTTCA	ExciteL6
CATTGTTAGAGAGCCT	ExciteL6
CATTGTTCAGGTATGG	ExciteL23
CATTGTTTCAAGGAGC	Microglia
CATTGTTTCACTACTT	ExciteNP
CATTTCAAGATGAATC	MOLs
CATTTCACACGCCAGT	InhibNeuron
CATTTCAGTCTGCAAT	MOLs
CATTTCAGTGTGGACA	ExciteL4
CATTTCAGTTCCTACC	Microglia
CCAAGCGGTATCATGC	Microglia
CCAAGCGTCGATTGAC	Microglia
CCAAGCGTCGGTAAGG	NIPCs
CCAAGCGTCTCAGAAC	Astrocytes
CCAAGCGTCTTCACGC	MOLs
CCAATGACAAATAAGC	Astrocytes
CCAATGACAAGGACAC	ExciteL4
CCAATGACACAACGCC	MOLs
CCAATGACAGAGGGTT	ExciteL4
CCAATGACATAGCTGT	MFOLs
CCAATGAGTACCGGAA	InhibNeuron
CCAATGAGTTGATGTC	COPs
CCAATGAGTTGCATGT	ExciteNP
CCAATGATCACACCCT	ExciteL6
CCAATGATCCTTGAAG	ExciteL4
CCAATGATCTTCCACG	OPCs
CCAATTTAGCTGGCTC	ExciteL4
CCAATTTCAAATCAAG	Microglia
CCAATTTCAAGAAACT	ExciteL6
CCAATTTCACGCCAGT	Microglia
CCAATTTTCAAGAGTA	Microglia
CCAATTTTCCCTCTTT	ExciteL4
CCAATTTTCGGCTTCT	InhibNeuron
CCACAAAAGTCATACC	MOLs
CCACAAACACCTGCGA	ExciteL23
CCACAAACAGAGTTGG	InhibNeuron
CCACAAACATAACCCA	OPCs
CCACAAAGTCGTTATG	OPCs
CCACAAAGTGAGACGT	ExciteL6
CCACAAAGTGCTAGCC	Astrocytes
CCACAAATCCTCTAAT	OPCs
CCACAAATCGAGGCAA	MOLs
CCACACTAGCACCAGA	InhibNeuron
CCACACTAGGACAAGA	ExciteL4
CCACACTCAGAATTCC	Microglia
CCACACTCAGAGATGC	Microglia
CCACACTCAGTTCACA	MOLs
CCACACTCATATGAAG	MOLs
CCACACTGTAGGCAGT	MOLs
CCACACTGTCCTCCAT	ExciteL6
CCACACTGTTAAGTCC	OPCs
CCACACTTCGATAACC	ExciteL4
CCACACTTCGCGTGCA	Astrocytes
CCACCATAGCTACTGT	Microglia
CCACCATAGTCGTCTA	ExciteL6
CCACCATGTAATCAAG	ExciteL6
CCACCATTCCCGTGAG	ExciteL4
CCACCATTCTCAGGCG	MOLs
CCACGAGCACCCTAGG	OPCs
CCACGAGCAGCTATTG	Microglia
CCACGAGGTAGCTGCC	Astrocytes
CCACGAGGTCATTCCC	ExciteL6
CCACGAGGTCGAATTC	Microglia
CCACGAGGTGGTAACG	Microglia
CCACGAGTCTGTTGGA	MOLs
CCACGTTAGGAGCTGT	ExciteL6
CCACGTTGTGAATTGA	MOLs
CCACGTTTCTCTTGCG	OPCs
CCACGTTTCTGGGTCG	COPs
CCACTTGAGATGAAGG	ExciteL4
CCACTTGAGGCTAACG	OPCs
CCACTTGAGTATTGCC	ExciteNP
CCACTTGAGTCTCTGA	OPCs
CCACTTGGTAACATGA	ExciteL6
CCACTTGGTAAGTAGT	InhibNeuron
CCACTTGGTGCCCTTT	Microglia
CCACTTGTCAGGAGAC	Astrocytes
CCACTTGTCCAATCTT	ExciteNP
CCACTTGTCTTGGCTC	MOLs
CCATAAGCAACACAAA	Microglia
CCATAAGCAGAACGCA	OPCs
CCATAAGCAGGGACTA	COPs
CCATAAGGTTCTCACC	OPCs
CCATCACCAATCTGCA	InhibNeuron
CCATCACCAGGTCCCA	ExciteL4
CCATCACGTCACTCGG	Astrocytes
CCATCACTCACGTCCT	Astrocytes
CCATCACTCACTACTT	MOLs
CCATCACTCCCGTTGT	MOLs
CCATCACTCCTTATCA	OPCs
CCCAACTGTACTGTTG	ExciteL6
CCCAACTGTAGCGAGT	ExciteL6
CCCAACTTCCTGTTGC	ExciteL4
CCCAACTTCTGAACGT	Astrocytes
CCCATTGAGATCCCGC	Astrocytes
CCCATTGAGCCAACCC	ExciteL6
CCCATTGCACTTGACA	Microglia
CCCATTGCAGTGTACT	ExciteL4
CCCATTGGTACTCGAT	Microglia
CCCATTGTCAGCAATC	ExciteL23
CCCATTGTCGGCCCAA	InhibNeuron
CCCATTGTCGTACACA	OPCs
CCCATTGTCTATGTGG	MOLs
CCCGAAGAGACGCTCC	Astrocytes
CCCGAAGAGAGATCGC	OPCs
CCCGAAGAGCGACTAG	ExciteL4
CCCGAAGAGCTTTCTT	NIPCs
CCCGAAGCACGAAAGC	Pericytes
CCCGAAGCAGAACTCT	MOLs
CCCGAAGCATAACTCG	ExciteL6
CCCGAAGGTATGTGTC	Astrocytes
CCCGAAGGTCGAATGG	ExciteL4
CCCGAAGGTTAAGGGC	ExciteL4
CCCGAAGGTTTACGTG	Microglia
CCCGAAGTCTACACAG	Astrocytes
CCCGGAAAGGATTCCT	ExciteL6
CCCGGAAAGGGAGTTC	OPCs
CCCGGAAAGGTAAGTT	InhibNeuron
CCCGGAAAGTGGTTGG	Microglia
CCCGGAACATGGCTAT	ExciteL23
CCCGGAAGTAAGAACT	Microglia
CCCGGAAGTAGAGCTG	ExciteL4
CCCGGAAGTCAACCTA	MOLs
CCCGGAAGTCAGTCCG	Microglia
CCCGGAAGTGCAATAA	Microglia
CCCGGAAGTGCTAGCC	ExciteL4
CCCGGAATCAAGGAGC	Microglia
CCCGGAATCTTACCGC	Microglia
CCCTAACAGCCAAGTG	Astrocytes
CCCTAACAGCTTTCTT	ExciteNP
CCCTAACCAGTCGCAC	OPCs
CCCTAACCATCCCACT	ExciteNP
CCCTAACGTGCGTTTA	ExciteL6
CCCTAACGTGGTCTAT	MOLs
CCCTCAAAGACGGAAA	Astrocytes
CCCTCAAAGCAATTCC	OPCs
CCCTCAAAGGCTTCCG	COPs
CCCTCAACAGCAAGAC	ExciteL4
CCCTCAACAGCGTGAA	MOLs
CCCTCAAGTACGATCT	ExciteL6
CCCTCAAGTTCATCGA	Microglia
CCCTCAATCCATAGGT	OPCs
CCCTCAATCCGATAGT	Astrocytes
CCCTCAATCTAACACG	ExciteL6
CCCTCTCCATATAGCC	Microglia
CCCTCTCCATGATAGA	COPs
CCCTGATAGAGTCGAC	Astrocytes
CCCTGATAGAGTGAAG	ExciteL23
CCCTGATAGGTTCATC	ExciteL4
CCCTGATGTGATCGTT	ExciteL23
CCCTGATTCATGAAAG	ExciteL4
CCCTGATTCGCGCTGA	Microglia
CCCTGATTCTACTGAG	Microglia
CCCTGATTCTGAGCAT	MOLs
CCCTTAGAGATGCTGG	Microglia
CCCTTAGAGATTGAGT	ExciteL6
CCCTTAGAGTTGTCAC	ExciteL6
CCCTTAGCAACCCTAA	OPCs
CCCTTAGGTAACACCT	ExciteL4
CCCTTAGGTTTCACAG	COPs
CCCTTAGTCCTAGAGT	MOLs
CCCTTAGTCTACGGTA	Microglia
CCGAACGAGCATTGAA	OPCs
CCGAACGCAAATGAGT	MOLs
CCGAACGCACTCAAGT	Astrocytes
CCGAACGCAGTTAGAA	ExciteL4
CCGAACGGTACCGCGT	MOLs
CCGAACGGTATGCTAC	Astrocytes
CCGATCTAGATGTTCC	InhibNeuron
CCGATCTAGCCTGAGA	ExciteL4
CCGATCTAGGTTCCGC	InhibNeuron
CCGATCTCAAGATTGA	ExciteNP
CCGATCTCAGCTATAC	COPs
CCGATCTGTAGCACAG	ExciteL6
CCGATCTGTCATGACT	OPCs
CCGATGGAGGGCAGGA	ExciteNP
CCGATGGGTCGAGATG	ExciteL6
CCGCAAGAGACGGTTG	MOLs
CCGCAAGAGACTCGAG	COPs
CCGCAAGCAAGGCGTA	ExciteL4
CCGCAAGCACCAGACC	ExciteL5
CCGCAAGCAGCCGTTG	ExciteL6
CCGCAAGGTCCGAAAG	MOLs
CCGCAAGGTGTCCAAT	OPCs
CCGCAAGTCCCGATCT	Astrocytes
CCGCAAGTCGCTGTCT	MOLs
CCGGACAAGCACGTCC	Microglia
CCGGACACAAATAGCA	Microglia
CCGGACACAACCAATC	InhibNeuron
CCGGACATCACGAACT	Ependymal
CCGGGTAAGTAAGCAT	OPCs
CCGGGTAAGTCACGAG	Microglia
CCGGGTACAGGACTTT	MOLs
CCGGGTACATAAGCGG	Microglia
CCGGGTAGTAGTATAG	Microglia
CCGGGTATCAAACGAA	MOLs
CCGGGTATCACTACTT	MOLs
CCGGGTATCTCCTGCA	Microglia
CCGGGTATCTGTTCAT	Microglia
CCGGTAGAGTACGTCT	MOLs
CCGGTAGAGTCAACAA	MOLs
CCGGTAGAGTTCATCG	Microglia
CCGGTAGCAAAGGCGT	MOLs
CCGGTAGCAGGGATAC	MOLs
CCGGTAGGTTAAACAG	Microglia
CCGGTAGTCAGGACAG	ExciteL6
CCGGTAGTCCATCAGA	OPCs
CCGGTAGTCTATTGTC	OPCs
CCGGTGAAGATCGCTT	ExciteL6
CCGGTGAAGGGCCTCT	ExciteL6
CCGGTGAAGTTGCGCC	MOLs
CCGGTGACAGTTTCGA	Microglia
CCGGTGAGTATGGAGC	ExciteL4
CCGGTGAGTGAAGCGT	ExciteL4
CCGGTGATCTGACCCT	ExciteL4
CCGTAGGAGAATAACC	ExciteL6
CCGTAGGAGAGTGTTA	Microglia
CCGTAGGAGCTGGCTC	ExciteL6
CCGTAGGCACTACACA	COPs
CCGTAGGCAGAGAATT	Astrocytes
CCGTAGGCATCGATAC	InhibNeuron
CCGTAGGGTCGAATGG	MOLs
CCGTAGGTCGACTCCT	MOLs
CCGTGAGAGGTTAAAC	InhibNeuron
CCGTGAGCATGTAACC	Microglia
CCGTGAGTCCGTGACG	ExciteL23
CCGTTCAAGATTAGTG	Microglia
CCGTTCACACTAGGTT	MOLs
CCGTTCACAGCGTACC	ExciteL6
CCGTTCAGTAGTCTGT	Microglia
CCGTTCAGTCTACATG	ExciteL23
CCGTTCAGTGTAGGAC	ExciteL4
CCTAACCAGATCGCCC	ExciteL6
CCTAACCCAAAGAACT	Microglia
CCTAACCCAACACGAG	OPCs
CCTAACCCACGAAAGC	Astrocytes
CCTAACCGTCGGAAAC	COPs
CCTAACCGTGATACTC	Astrocytes
CCTAACCGTTAGGACG	Endo
CCTAAGAGTCGCGGTT	MOLs
CCTAAGAGTCGTAATC	OPCs
CCTAAGAGTGACAACG	Microglia
CCTAAGAGTGGTATGG	ExciteL4
CCTAAGATCCATCCGT	ExciteL6
CCTAAGATCCGTGGTG	InhibNeuron
CCTAAGATCGGATACT	MOLs
CCTAAGATCGGTGAAG	Microglia
CCTAAGATCGTGGGTC	MOLs
CCTAAGATCTACTTCA	Microglia
CCTAAGATCTCGTCAC	MOLs
CCTACGTCAACGATTC	OPCs
CCTACGTGTAAGTTGA	Astrocytes
CCTACGTGTATTCCTT	MOLs
CCTACGTTCAAGCTTG	MOLs
CCTACGTTCGCCCAGA	ExciteL4
CCTACGTTCTCACGAA	MFOLs
CCTATCGAGGAATTAC	ExciteL4
CCTATCGAGTTCTACG	Astrocytes
CCTATCGGTCGTTCAA	ExciteL4
CCTATCGGTTCACGAT	OPCs
CCTATCGGTTCCCAAA	OPCs
CCTATCGTCCAGTACA	DivOPCs
CCTATCGTCCGATAGT	MOLs
CCTCAACCATCCGTGG	ExciteL6
CCTCAACGTAACGATA	Astrocytes
CCTCAACGTTCGGGTC	ExciteL6
CCTCAACGTTTCGTGA	InhibNeuron
CCTCAACTCAGGAGAC	ExciteL4
CCTCAACTCCATTTGT	InhibNeuron
CCTCAACTCGAGATAA	Fibroblasts
CCTCAACTCGTCTACC	ExciteL6
CCTCAACTCTAAACGC	COPs
CCTCAACTCTTGGCTC	ExciteL23
CCTCACAAGAAGTATC	COPs
CCTCACAAGAATAGTC	ExciteL4
CCTCACAAGATAGCTA	MOLs
CCTCACAAGATTAGAC	Microglia
CCTCACAAGGAAGTGA	ExciteL4
CCTCACAAGTTTCAGC	NIPCs
CCTCACACAAAGACTA	Microglia
CCTCACACAAGTGCAG	Microglia
CCTCACACACCCTCTA	OPCs
CCTCACACACTCCGAG	Microglia
CCTCACACAGTATTCG	ExciteL23
CCTCACAGTTCGGCTG	MOLs
CCTCACATCTGCGAGC	MOLs
CCTCAGTAGCAGCCTC	MOLs
CCTCAGTAGCTACTGT	OPCs
CCTCAGTCAACCGACC	ExciteL4
CCTCAGTCACCCATAA	ExciteL4
CCTCAGTGTGACTAAA	Microglia
CCTCAGTGTGATAGTA	MOLs
CCTCAGTGTTGCATTG	Microglia
CCTCAGTGTTGTCATG	MOLs
CCTCAGTTCTGTTGGA	MOLs
CCTCATGAGTCTGGTT	MOLs
CCTCATGCAACAGCTT	MOLs
CCTCATGCACAGTGTT	Astrocytes
CCTCATGCATGTCAGT	Microglia
CCTCATGGTCACGACC	ExciteNP
CCTCATGGTCGACTTA	ExciteL4
CCTCATGTCAGGAAAT	MOLs
CCTCATGTCCTACAAG	MOLs
CCTCATGTCCTCTAAT	ExciteL4
CCTCATGTCCTTCTTC	Microglia
CCTCCAACAAGCTCTA	ExciteL4
CCTCCAACACTATGTG	Macrophages
CCTCCAACACTCTCGT	OPCs
CCTCCAAGTCTCTCCA	Astrocytes
CCTCCAAGTCTGTGAT	Astrocytes
CCTCCAATCCAAGCAT	MOLs
CCTCCTCCATCCGATA	InhibNeuron
CCTCCTCTCTGGCCAG	MOLs
CCTCTAGAGACCGTTT	MOLs
CCTCTAGAGTATGAGT	Astrocytes
CCTCTAGGTATCTTCT	InhibNeuron
CCTCTAGGTGTGTGTT	OPCs
CCTCTAGTCCTTATGT	MOLs
CCTCTAGTCGACACTA	ExciteL23
CCTCTAGTCGCCAGTG	MOLs
CCTCTCCAGATGTAGT	Astrocytes
CCTCTCCAGGTCGCCT	Endo
CCTCTCCCAGGTGTGA	MOLs
CCTCTCCTCGCACGAC	ExciteL4
CCTGCATAGTTGGCGA	Astrocytes
CCTGCATCACCAACAT	Microglia
CCTGCATCAGATACCT	ExciteL23
CCTGCATCATGTTACG	Microglia
CCTGCATGTATCTCGA	MOLs
CCTGCATGTCAATCTG	MOLs
CCTGCATTCAAGCCAT	InhCajalRetzius
CCTGTTGAGATTAGCA	OPCs
CCTGTTGAGCTGAGTG	ExciteL4
CCTGTTGCACGACGAA	Microglia
CCTGTTGCAGGACAGT	ExciteL6
CCTGTTGCATCATCCC	ExciteL4
CCTGTTGGTCTCGACG	ExciteNP
CCTGTTGGTGAGCTCC	ExciteL23
CCTGTTGGTTGCCATA	ExciteNP
CCTGTTGTCTCTCCGA	ExciteL23
CCTTCAGAGAGTCAGC	ExciteL4
CCTTCAGCAAGGTCAG	ExciteL4
CCTTCAGCATCGGCCA	Microglia
CCTTCAGGTGCAGGAT	ExciteL4
CCTTCAGTCCACGTCT	Microglia
CCTTCAGTCCCATTCG	MOLs
CCTTCAGTCGAGAGAC	ExciteL4
CCTTCAGTCGCTAATG	Microglia
CCTTGTGAGGAAACGA	ExciteL23
CCTTGTGCACATAGCT	Microglia
CCTTGTGCATCTAACG	ExciteL4
CCTTGTGGTGAGGAAA	NIPCs
CCTTGTGGTGGGAGAG	OPCs
CCTTGTGTCGTGGCTG	InhibNeuron
CCTTTGGCATCGCTCT	Astrocytes
CCTTTGGGTCTACGAT	OPCs
CCTTTGGTCACAATGC	ExciteL4
CCTTTGGTCATTGCGA	Astrocytes
CCTTTGGTCCGCAAAT	NIPCs
CCTTTGGTCGTGTGAT	Endo
CCTTTGGTCTTCACAT	Microglia
CGAAGGAAGGACAGTC	COPs
CGAAGGACAAGACTGG	Microglia
CGAAGGACAATCGCAT	Microglia
CGAAGGACATGACACT	COPs
CGAAGGAGTCTTCCGT	Astrocytes
CGAAGGAGTGCTGCAC	Astrocytes
CGAAGGAGTTCAGCGC	ExciteL6
CGAAGGATCGAACACT	ExciteL4
CGAAGGATCGGACTTA	Astrocytes
CGAAGTTAGAAGTCTA	ExciteL5
CGAAGTTAGGTAGACC	InhibNeuron
CGAAGTTAGTCCCAGC	ExciteL4
CGAAGTTAGTGGAATT	Microglia
CGAAGTTAGTGTAGTA	ExciteL4
CGAAGTTCAAATGAAC	Pericytes
CGAAGTTCACAGTGTT	Microglia
CGAAGTTCAGTCAACT	Astrocytes
CGAAGTTCATGTTACG	Microglia
CGAAGTTGTCACTAGT	Macrophages
CGAAGTTGTCCGGTCA	ExciteL5
CGAAGTTGTTCCGCAG	ExciteL4
CGAAGTTTCATAAGGA	MOLs
CGAAGTTTCCAAGAGG	InhibNeuron
CGAAGTTTCGGTCATA	ExciteL4
CGAATTGAGAGTGAAG	ExciteL6
CGAATTGAGCTAGCCC	ExciteL6
CGAATTGAGTTCCAGT	Microglia
CGAATTGCAAATCAGA	COPs
CGAATTGCACGTTGGC	NIPCs
CGAATTGGTCGAAGCA	MOLs
CGAATTGGTGAGGAAA	ExciteL4
CGAATTGGTGCCTATA	Microglia
CGAATTGGTTGTTGTG	Microglia
CGAATTGTCGCTAGCG	ExciteL4
CGAATTGTCTACTGCC	ExciteL4
CGACAGCAGTTGCTCA	Astrocytes
CGACAGCCACGCAGTC	Microglia
CGACAGCGTGCAACAG	Astrocytes
CGACAGCGTTGCCTAA	Microglia
CGAGAAGAGGTAGCCA	Microglia
CGAGAAGCAAGACCTT	ExciteL6
CGAGAAGCAGCTGTGC	ExciteL6
CGAGAAGCAGGTGTTT	Microglia
CGAGAAGCATCGCTCT	ExciteL5
CGAGAAGGTGAGAACC	ExciteL4
CGAGAAGGTTATGACC	Microglia
CGAGAAGTCGAGGCAA	Microglia
CGAGAAGTCGTGTCAA	Endo
CGAGGAAAGCGTTCCG	ExciteL6
CGAGGAACAAAGGCAC	ExciteL6
CGAGGAACATCCTTGC	ExciteL23
CGAGGAAGTTAAGAAC	Microglia
CGAGGAATCAACACGT	Microglia
CGAGGAATCGATTCCC	Astrocytes
CGAGGCTAGTACTCGT	OPCs
CGAGGCTCAACCGTAT	MOLs
CGAGGCTCAAGAGTTA	MOLs
CGAGTGCAGCGACCCT	COPs
CGAGTGCAGTCCTGTA	ExciteL6
CGAGTGCAGTGGTTAA	ExciteL4
CGAGTGCCACGTACTA	MOLs
CGAGTGCCAGGGCTTC	ExciteNP
CGAGTGCCAGTATACC	Microglia
CGAGTGCGTATGAGAT	ExciteL6
CGAGTTAAGCGTGAAC	Astrocytes
CGAGTTAAGCGTGCTC	ExciteL4
CGAGTTACAGACCGCT	Astrocytes
CGAGTTACAGCCCACA	MOLs
CGAGTTACAGGATGAC	ExciteL6
CGAGTTATCCACTGAA	Microglia
CGAGTTATCCCAAGTA	ExciteL23
CGAGTTATCTTTCCGG	MOLs
CGATCGGAGCGATGGT	Microglia
CGATCGGCACCAGACC	InhibNeuron
CGATCGGCATAGGTTC	Astrocytes
CGATCGGGTCTTTCTA	MOLs
CGATCGGGTGTCCATA	ExciteL23
CGATCGGTCAGACATC	ExciteL6
CGATCGGTCCATTGGA	ExciteL4
CGATGCGAGATGGTAT	MOLs
CGATGCGCAGAATCGG	ExciteL4
CGATGCGCAGCATTGT	Microglia
CGATGCGCAGTTTCAG	ExciteL6
CGATGCGGTACGAGCA	MOLs
CGATGCGGTAGCGATG	MOLs
CGATGCGTCCCGATCT	Microglia
CGATGCGTCGAAACAA	InhibNeuron
CGATGCGTCTGCCTCA	MOLs
CGATGGCAGAGTTGCG	ExciteL23
CGATGGCCAATGTCTG	InhibNeuron
CGATGGCCACTCACTC	ExciteL6
CGATGGCCATTCATCT	ExciteL4
CGATGGCGTCGCAGTC	Microglia
CGATGGCGTGACAACG	ExciteL23
CGATGGCGTTAAACAG	ExciteL6
CGCAGGTAGACGCATG	Astrocytes
CGCAGGTCAATACGCT	MOLs
CGCAGGTCAGGGCTTC	Microglia
CGCAGGTGTAGATTAG	OPCs
CGCAGGTGTCACTCTC	Microglia
CGCAGGTGTGGGATTG	MOLs
CGCAGGTTCCATTTCA	ExciteL4
CGCAGGTTCTGAGAAA	Microglia
CGCATAAAGCCAAGTG	ExciteL4
CGCATAACAAGAGAGA	ExciteL4
CGCATAACAGGTCCCA	Astrocytes
CGCATAAGTGGTCCCA	OPCs
CGCATAATCGTCAACA	ExciteL23
CGCATGGAGAGCCTGA	COPs
CGCATGGAGGAACGTC	Microglia
CGCATGGAGGCTGTAG	ExciteL6
CGCATGGCACCGTGCA	MOLs
CGCATGGCATTGGGAG	ExciteL6
CGCATGGGTCATAACC	MOLs
CGCATGGGTCCTACAA	Microglia
CGCATGGGTGCCTACG	OPCs
CGCATGGTCCTACAAG	ExciteL6
CGCATGGTCGGCTTGG	Microglia
CGCATGGTCGTGTTCC	Microglia
CGCATGGTCTCATGCC	Astrocytes
CGCCAGAAGCCAAGCA	ExciteL4
CGCCAGAAGCCACCGT	ExciteL5
CGCCAGAAGGACTAAT	OPCs
CGCCAGACAGCTTTGA	MOLs
CGCCAGACATGCACTA	MOLs
CGCCAGATCACTTGTT	ExciteL6
CGCCAGATCATCGGGC	Endo
CGCCAGATCGAGTCCG	ExciteL4
CGCCAGATCTGGGATT	OPCs
CGCCATTAGCAATTAG	ExciteL4
CGCCATTAGCAGCCCT	ExciteL5
CGCCATTCATTCTTCA	Astrocytes
CGCCATTGTGAGATCG	ExciteNP
CGCCATTGTGAGGCAT	ExciteL4
CGCCATTTCATCGCCT	Endo
CGCCATTTCGCGTGCA	Astrocytes
CGCCATTTCTCTCAAT	InhibNeuron
CGCGTGAAGCGTGAGT	OPCs
CGCGTGAAGTGTTGTC	InhibNeuron
CGCGTGACACGCGTGT	ExciteL6
CGCGTGAGTAACCCGC	Astrocytes
CGCGTGATCCGCGATG	ExciteL4
CGCGTGATCGTTAGAC	OPCs
CGGAACCAGCTAGAGC	ExciteL6
CGGAACCAGTTGGGAC	ExciteL6
CGGAACCCAAATGGTA	Microglia
CGGAACCCAAGTCCCG	Astrocytes
CGGAACCCACAACATC	OPCs
CGGAACCCAGTATTCG	InhibNeuron
CGGAACCCATGCCATA	ExciteL4
CGGAACCGTAGTCCTA	Endo
CGGAACCGTTGCTGAT	Astrocytes
CGGAATTAGTATGGCG	MOLs
CGGAATTCAGCGTAGA	Macrophages
CGGAATTCAGTTGTCA	COPs
CGGAATTGTCGGAAAC	COPs
CGGAATTGTTCAGCGC	Microglia
CGGAATTGTTGCAACT	Microglia
CGGAATTGTTTGCAGT	COPs
CGGAATTTCGTTCCCA	ExciteL4
CGGAATTTCTATCCAT	Microglia
CGGAATTTCTTCCCAG	ExciteL6
CGGACACAGACGGTCA	ExciteL4
CGGACACAGCACTCTA	ExciteL4
CGGACACAGGCGAACT	Microglia
CGGACACAGTGCAAAT	NIPCs
CGGACACCAAAGTGTA	InhibNeuron
CGGACACCAATAACGA	ExciteL6
CGGACACCAGGAATAT	OPCs
CGGACACGTCGTCAGC	Pericytes
CGGACACTCATGGTAC	OPCs
CGGAGAAAGAGCCGTA	Astrocytes
CGGAGAAAGGGCTTCC	NIPCs
CGGAGAAAGTAGAATC	ExciteL4
CGGAGAAAGTGGTCAG	OPCs
CGGAGAACACTGCGTG	ExciteL23
CGGAGAACATCATCTT	MOLs
CGGAGAATCAAGTTGC	ExciteL6
CGGAGAATCACTTGTT	NIPCs
CGGAGAATCGGCTGAC	COPs
CGGCAGTCAAGCCTGC	ExciteL4
CGGCAGTCATATACCG	ExciteL4
CGGCAGTGTTCGTACA	Astrocytes
CGGCAGTTCCCATAAG	Microglia
CGGGACTAGGCATGGT	MOLs
CGGGACTCACAACGCC	Astrocytes
CGGGACTGTGTGGACA	ExciteNP
CGGGACTGTTGTTGCA	COPs
CGGGACTTCCCTTGGT	OPCs
CGGGCATAGAAGCTCG	NIPCs
CGGGCATAGGAAGTGA	OPCs
CGGGCATAGGTTCCAT	MOLs
CGGGCATCAAATCAGA	OPCs
CGGGCATCACGAAAGC	ExciteL4
CGGGCATGTAGTCCTA	Microglia
CGGGCATGTGAATGAT	ExciteL6
CGGGCATGTTAAGTCC	OPCs
CGGGCATTCACACCCT	MOLs
CGGGCATTCAGATTGC	MOLs
CGGGCATTCATGAGGG	MOLs
CGGGCATTCGTGTGGC	ExciteL6
CGGGCATTCTCGAACA	Microglia
CGGGCATTCTTTCTAG	COPs
CGGGTCAAGGGAGAAT	ExciteL4
CGGGTCACAGCTTCCT	ExciteL5
CGGGTCACAGTTGGTT	ExciteL23
CGGGTCACATCGGTTA	ExciteL4
CGGGTCATCCAGTTCC	ExciteL23
CGGGTCATCCGCGAGT	ExciteL23
CGGGTCATCTAGCCTC	ExciteL4
CGGGTCATCTAGTTCT	OPCs
CGGGTGTAGGCATCTT	ExciteL4
CGGGTGTAGTAAGCAT	Microglia
CGGGTGTCAGCAGTAG	MOLs
CGGGTGTGTCAAAGCG	OPCs
CGGGTGTGTCCTCATC	OPCs
CGGGTGTGTGAGTTTC	ExciteL23
CGGGTGTGTTGCTTGA	Astrocytes
CGGGTGTTCGACCCAG	ExciteL4
CGGTCAGAGCTGACAG	OPCs
CGGTCAGAGGGCAATC	ExciteL5
CGGTCAGAGTTAGAAC	ExciteL6
CGGTCAGCAGGCACTC	COPs
CGGTCAGTCGCAAGAG	MOLs
CGGTCAGTCTCCCTAG	MOLs
CGGTCAGTCTGCTAGA	OPCs
CGTAAGTAGTCTTCGA	ExciteL4
CGTAAGTCAAGTGGAC	MOLs
CGTAAGTCAGAATTCC	COPs
CGTAAGTGTAGCGTCC	ExciteL4
CGTAAGTGTCGAATTC	InhibNeuron
CGTAAGTTCACACGAT	COPs
CGTAAGTTCCTGCTAC	NIPCs
CGTAAGTTCGTCCTTG	MOLs
CGTAATGAGACGGTTG	Astrocytes
CGTAATGAGCCTCACG	ExciteL4
CGTAATGCAACTCCAA	ExciteL4
CGTAATGCAATTTCCT	OPCs
CGTAATGCATACCAGT	Astrocytes
CGTAATGGTCACCCTT	ExciteL5
CGTAATGGTGCTCGTG	MOLs
CGTAATGTCGCAGTGC	Pericytes
CGTAATGTCGGAGTGA	Microglia
CGTAATGTCGTGCACG	OPCs
CGTAGTACACAGAGCA	ExciteL6
CGTAGTAGTCGACTGC	ExciteL4
CGTAGTAGTTCAAGTC	ExciteL6
CGTAGTAGTTTACTGG	MOLs
CGTAGTATCCCTGTTG	ExciteL23
CGTAGTATCCGGCAGT	ExciteL4
CGTAGTATCGCAGATT	ExciteL6
CGTCAAAAGGTGCCAA	Astrocytes
CGTCAAACAACTAGAA	Astrocytes
CGTCAAAGTGCTGCAC	ExciteL4
CGTCCATAGCATCTTG	ExciteL4
CGTCCATCAGGAGGAG	NIPCs
CGTCCATGTAGATGTA	MOLs
CGTCCATGTCTGTGTA	Microglia
CGTCCATTCACCTGGG	ExciteL6
CGTCCATTCAGAACCT	MOLs
CGTCCATTCCATCAGA	ExciteL4
CGTCCATTCTAGGAAA	ExciteL4
CGTGAATAGAGAAGGT	ExciteL4
CGTGAATAGGCTTCCG	ExciteL4
CGTGAATCACAGTGTT	ExciteL4
CGTGAATCACGGCACT	ExciteL4
CGTGAATGTATGCTTG	MOLs
CGTGAATGTTGTCCCT	OPCs
CGTGATAAGGTCTGGA	Astrocytes
CGTGATACAACGTTAC	MOLs
CGTGATACACAATCTG	Macrophages
CGTGATAGTATCGAAA	MOLs
CGTGATAGTGAACGGT	ExciteL4
CGTGATAGTTAAGACA	ExciteL4
CGTGATATCGGAATTC	Astrocytes
CGTGATATCTCGACCT	Microglia
CGTGCTTAGCATCAAA	InhibNeuron
CGTGCTTAGGATTCCT	ExciteL4
CGTGCTTCATTAGGCT	Astrocytes
CGTGTCTAGACTTAAG	MOLs
CGTGTCTAGTCACTCA	Microglia
CGTGTCTAGTCATTGC	OPCs
CGTGTCTAGTTACGAA	MOLs
CGTGTCTCACAACGAG	OPCs
CGTGTCTGTCAGATTC	Microglia
CGTGTCTGTCCCTCAT	ExciteL6
CGTGTCTGTCGGATTT	Microglia
CGTGTCTGTTAAGGGC	InhibNeuron
CGTGTCTTCCGTATGA	MOLs
CGTGTCTTCGCATTGA	ExciteL23
CGTGTCTTCTAGTACG	ExciteL6
CGTTAGAAGATAGCTA	ExciteL4
CGTTAGAAGCCTGTCG	ExciteL6
CGTTAGAGTAGATGTA	OPCs
CGTTAGAGTAGTTAGA	MOLs
CGTTAGAGTTCGGCGT	MOLs
CGTTAGATCAGAGCGA	ExciteL6
CGTTAGATCGATAACC	OPCs
CGTTCTGAGCTAAGTA	Microglia
CGTTCTGAGTGCCCGT	MOLs
CGTTCTGCAACCCGCA	ExciteL6
CGTTCTGCAGCATACT	ExciteL4
CGTTCTGGTGCTGATT	OPCs
CGTTCTGTCAACTGGT	OPCs
CGTTCTGTCACAGAGG	ExciteL6
CGTTCTGTCTCTATAC	OPCs
CGTTGGGAGACATAGT	Fibroblasts
CGTTGGGAGCCATATC	ExciteL4
CGTTGGGAGCGGTAAC	ExciteL6
CGTTGGGAGTGACCTT	MOLs
CGTTGGGCACCGTGAC	MOLs
CGTTGGGCACGTCATA	Microglia
CGTTGGGGTGGGCTCT	OPCs
CGTTGGGGTTCGAAGG	ExciteL4
CGTTGGGTCGTAGTCA	InhibNeuron
CTAACCCAGAGGGTCT	MOLs
CTAACCCAGCTGACCC	InhibNeuron
CTAACCCAGGGCAGGA	Astrocytes
CTAACCCAGGGCAGTT	Microglia
CTAACCCCACATATCG	ExciteNP
CTAACCCGTGGGTCAA	MOLs
CTAACCCGTTGCTTGA	Microglia
CTAACCCGTTGGTGTT	Microglia
CTAACCCTCCACTTTA	Astrocytes
CTAACTTAGACTCTAC	Microglia
CTAACTTAGTAAATGC	MOLs
CTAACTTAGTCAGAGC	ExciteL23
CTAACTTCAGTTAAAG	ExciteL4
CTAACTTCAGTTGGTT	Astrocytes
CTAACTTGTGATACAA	MOLs
CTAACTTGTTATGGTC	ExciteL5
CTAACTTGTTGGGATG	ExciteNP
CTAACTTGTTGGGCCT	MOLs
CTAACTTTCGCTAAAC	MOLs
CTAAGTGAGAACTTCC	ExciteL6
CTAAGTGAGGATATAC	Microglia
CTAAGTGAGTTCCTGA	Astrocytes
CTAAGTGCAAGACTGG	ExciteL4
CTAAGTGCATGACAAA	ExciteL6
CTAAGTGGTCGAGTGA	ExciteL23
CTAAGTGGTGGCTGAA	Microglia
CTAAGTGTCCGCTGTT	ExciteL4
CTACAGAAGCCATATC	ExciteL4
CTACAGAAGTTACGAA	Astrocytes
CTACAGACAATCGAAA	MOLs
CTACAGACACATTGTG	InhibNeuron
CTACAGACATGGGTTT	ExciteL4
CTACAGAGTCCAACGC	Endo
CTACAGATCGTTGCCT	ExciteL4
CTACAGATCTTGCAGA	InhibNeuron
CTACATTCACGCAAAG	ExciteL6
CTACATTCACTCATAG	OPCs
CTACATTCAGATAAAC	MOLs
CTACATTGTCTGTGGC	Astrocytes
CTACATTTCCCGTGAG	MOLs
CTACATTTCGCGCCAA	Microglia
CTACATTTCTTAGCAG	MOLs
CTACATTTCTTTGCAT	Microglia
CTACCCAAGAAACCAT	ExciteL6
CTACCCAAGCCGATAG	NIPCs
CTACCCAAGGCCTGCT	ExciteL23
CTACCCAAGGCGACAT	Microglia
CTACCCAAGTTAACAG	ExciteL23
CTACCCAGTCAAAGCG	MOLs
CTACCCAGTCTAGATC	Astrocytes
CTACCCAGTTACGGAG	ExciteL6
CTACCCATCCCTTCCC	NIPCs
CTACCCATCCTACAAG	ExciteL4
CTACCCATCGAGGCAA	NIPCs
CTACCCATCTGAATGC	Astrocytes
CTACCTGAGAGCCCAA	Microglia
CTACCTGAGCAGGGAG	ExciteNP
CTACCTGAGCATGCAG	OPCs
CTACCTGAGCCTTTGA	Endo
CTACCTGAGCTATCCA	MOLs
CTACCTGAGGCTCCCA	Microglia
CTACCTGCACTTTAGG	MOLs
CTACCTGGTGCTCGTG	ExciteL6
CTACCTGTCCGCAGTG	ExciteL4
CTACCTGTCGAGTCTA	ExciteL4
CTACGGGAGACCTTTG	OPCs
CTACGGGAGGAATCGC	Astrocytes
CTACGGGAGTAGATCA	Microglia
CTACGGGCAAGCACAG	DivOPCs
CTACGGGGTCAAAGCG	Pericytes
CTACGGGGTCCAAATC	ExciteL4
CTACGGGTCGAACGCC	ExciteL4
CTACTATAGCACAAAT	ExciteL4
CTACTATCACCATATG	Microglia
CTACTATCATTCTTCA	COPs
CTACTATGTAGAGTTA	OPCs
CTACTATGTATCACCA	ExciteL4
CTACTATGTTCGGTTA	InhibNeuron
CTACTATTCCCGAAAT	ExciteL4
CTAGACACACGAGGAT	Astrocytes
CTAGACACAGACATCT	OPCs
CTAGACACATACTGAC	ExciteNP
CTAGACAGTGCCCACA	Microglia
CTAGACATCCTGCCAT	Endo
CTAGACATCTAAGCCA	ExciteL6
CTAGGTAAGAGGTTTA	MOLs
CTAGGTAAGGCTCCCA	Microglia
CTAGGTACAGCATACT	MOLs
CTAGGTACATCCCGTT	Astrocytes
CTAGGTACATGACTGT	COPs
CTAGGTAGTCCAGAAG	Microglia
CTAGGTAGTGTGCCTG	ExciteL23
CTAGGTATCAGTCAGT	ExciteL4
CTATAGGAGACCATAA	NIPCs
CTATAGGCAACCCTAA	ExciteL6
CTATAGGCACGCGTGT	OPCs
CTATAGGCACGTTCGG	Microglia
CTATAGGCATTGACAC	Astrocytes
CTATAGGTCCGTGGGT	ExciteL4
CTATAGGTCGGCTGAC	ExciteL23
CTATCCGCATGACAAA	ExciteL6
CTATCCGCATGCCGCA	Astrocytes
CTATCCGGTTTCGGCG	Microglia
CTATCCGTCCGTCAAA	ExciteL6
CTATCCGTCGACATTG	ExciteL4
CTATCCGTCTCTATGT	InhibNeuron
CTATCTAAGAGGATCC	MOLs
CTATCTAAGATAGCAT	ExciteL5
CTATCTAAGTTGCCTA	Microglia
CTATCTACACTGATTG	Microglia
CTATCTACATTCATCT	Astrocytes
CTATCTAGTACGACTT	ExciteL6
CTATCTAGTATCACGT	ExciteL4
CTATCTAGTCGTGTTA	InhibNeuron
CTATCTAGTGTCCACG	MOLs
CTATCTAGTGTGCCTG	MOLs
CTATCTAGTTCAAGTC	MOLs
CTATCTATCCAACCGG	Microglia
CTATCTATCTCCGAAA	InhibNeuron
CTCAACCAGAATGTTG	ExciteL4
CTCAACCCAATTAGGA	Astrocytes
CTCAACCGTCAAGCCC	Microglia
CTCAACCGTGTTTGCA	ExciteL4
CTCAACCGTTGCCGAC	Microglia
CTCAACCTCCACGGGT	Microglia
CTCAACCTCCTCACTG	MOLs
CTCAAGAAGAGGATGA	Microglia
CTCAAGAAGCCATATC	ExciteNP
CTCAAGAGTAGGCTGA	ExciteL6
CTCAAGAGTCGTCGGT	InhibNeuron
CTCAAGAGTTACCGTA	OPCs
CTCAAGAGTTGCTAGT	Microglia
CTCAAGATCCGCATAA	Endo
CTCAAGATCGTGCAGC	Microglia
CTCAATTAGCCGATAG	Microglia
CTCAATTAGGGCTTCC	ExciteL4
CTCAATTAGTGCAAAT	ExciteNP
CTCAATTCAACGGTAG	ExciteL6
CTCAATTCAACTTCTT	OPCs
CTCAATTGTATGGAAT	ExciteL4
CTCAATTGTTCGTGCG	OPCs
CTCAATTTCGGACCAC	ExciteL6
CTCAATTTCTCCGAGG	ExciteL4
CTCAATTTCTTCGGTC	ExciteL4
CTCACTGAGAGCAAGA	ExciteL5
CTCACTGAGAGTCTTC	OPCs
CTCACTGCAAGCCATT	COPs
CTCACTGCATCGCTAA	OPCs
CTCACTGCATGCAGCC	ExciteL23
CTCACTGTCGTACCTC	Microglia
CTCACTGTCTACGGGC	Microglia
CTCAGAACAATCGCGC	Astrocytes
CTCAGAAGTGGATACG	InhibNeuron
CTCAGAAGTTGCTAGT	OPCs
CTCAGGGAGAATACAC	Microglia
CTCAGGGAGATAACAC	ExciteL4
CTCAGGGAGGCCATAG	Macrophages
CTCAGGGCAAACGAGC	ExciteL4
CTCAGGGCAAATGAGT	ExciteL4
CTCAGTCAGGATGGCT	MOLs
CTCAGTCCACCTCGTT	MOLs
CTCAGTCGTGTCATGT	ExciteL4
CTCAGTCTCTGCCTGT	InhibNeuron
CTCATCGAGGGCATGT	MOLs
CTCATCGAGGTTCCAT	Microglia
CTCATCGCATTCACCC	Microglia
CTCATCGGTAGTCGGA	Astrocytes
CTCATCGGTATCCCTC	Endo
CTCATCGGTGATACTC	ExciteL4
CTCATCGGTTACACTG	Pericytes
CTCATCGGTTGGCTAT	ExciteL4
CTCATGCAGCTGAGTG	Microglia
CTCATGCAGTTCCGTA	MOLs
CTCATGCCACTGTCGG	Astrocytes
CTCATGCGTCGTACAT	ExciteL4
CTCATGCGTCTCAGGC	MOLs
CTCATGCGTTACCTGA	OPCs
CTCATTAAGGCAATGC	Microglia
CTCATTACAATGTTGC	Microglia
CTCATTACATGGGAAC	ExciteL6
CTCATTAGTATTTCTC	Microglia
CTCATTAGTCAGTCGC	Pericytes
CTCATTAGTGTACATC	Astrocytes
CTCATTATCCTTCAGC	InhibNeuron
CTCATTATCTAGCAAC	ExciteL4
CTCCAACAGAGGGCGA	Microglia
CTCCAACAGCACTAAA	Microglia
CTCCAACCACTCCCTA	ExciteL6
CTCCAACTCAGGTGTT	COPs
CTCCACACACTACTTT	ExciteL4
CTCCACAGTATCATGC	Astrocytes
CTCCACAGTCTTTATC	Microglia
CTCCACAGTGGGTATG	Microglia
CTCCACAGTTAAACAG	ExciteL6
CTCCACAGTTCACGAT	OPCs
CTCCACAGTTCTCGCT	NIPCs
CTCCACATCGAAATCC	InhibNeuron
CTCCACATCGGAGATG	Microglia
CTCCACATCTACTTCA	MOLs
CTCCATGAGGAGAGGC	Microglia
CTCCATGAGGTAACTA	Astrocytes
CTCCATGTCCAATCCC	Astrocytes
CTCCATGTCGAGAATA	Macrophages
CTCCCAAAGACCTGGA	Astrocytes
CTCCCAAAGAGTTGTA	Microglia
CTCCCAACAAGATCCT	Astrocytes
CTCCCAACACAACATC	MOLs
CTCCCAACATCTCATT	ExciteL6
CTCCCAAGTCTTTATC	Pericytes
CTCCCAAGTGGTTCTA	ExciteL4
CTCCCAATCAAACTGC	OPCs
CTCCCAATCGCTCATC	ExciteL4
CTCCCAATCTGTGCAA	MOLs
CTCCCTCCAAACTGCT	ExciteL6
CTCCCTCCAAATGATG	Microglia
CTCCCTCGTCCGCAGT	MOLs
CTCCCTCGTTGCAACT	Microglia
CTCCCTCTCACTGAAC	Microglia
CTCCCTCTCCGATGTA	MOLs
CTCCCTCTCCGCGAGT	Microglia
CTCCCTCTCTACCACC	ExciteL4
CTCCCTCTCTCCGCAT	Microglia
CTCCCTCTCTGAGGTT	Microglia
CTCCGATCACAAAGCG	ExciteL4
CTCCGATCAGAGTTCT	ExciteL4
CTCCGATCATCCGATA	ExciteL23
CTCCGATGTACTCGCG	ExciteL6
CTCCGATGTTGCCGCA	Astrocytes
CTCCGATTCGTAGCCG	Microglia
CTCCTCCAGAATGTTG	Microglia
CTCCTCCAGCCTGAGA	Microglia
CTCCTCCAGCTTAGTC	ExciteL4
CTCCTCCGTAGACTGG	COPs
CTCCTCCGTCGAACGA	ExciteL6
CTCCTCCGTTTCACTT	MOLs
CTCCTCCTCACAGTGT	MOLs
CTCCTTTCACCCAAGC	Microglia
CTCCTTTCAGGAATAT	OPCs
CTCCTTTGTCCCTGTT	ExciteL4
CTCCTTTTCAGGAAAT	ExciteL5
CTCGAGGAGACGTCCC	Astrocytes
CTCGAGGAGCTGTGCC	Astrocytes
CTCGAGGAGGCAGTCA	ExciteL6
CTCGAGGCACCAGTTA	Microglia
CTCGAGGCATAACGGG	Microglia
CTCGAGGGTGCCTACG	Microglia
CTCGAGGGTGTCCATA	MOLs
CTCGAGGTCCAATGCA	Microglia
CTCGAGGTCCCATTTA	ExciteL4
CTCTCAGAGCTCGCAC	ExciteL4
CTCTCAGAGCTCGGCT	ExciteL4
CTCTCAGAGGGAGGAC	InhibNeuron
CTCTCAGAGTCCCGAC	MOLs
CTCTCAGCAACCGCCA	ExciteL6
CTCTCAGCATGGCCCA	OPCs
CTCTCAGTCACTCGAA	MOLs
CTCTCAGTCTCAATCT	InhibNeuron
CTCTCGAAGCTTTGTG	MOLs
CTCTCGAAGGCTATCT	Pericytes
CTCTCGACAGGTCAAG	NIPCs
CTCTCGACATCCAATG	InhibNeuron
CTCTCGAGTCTGCGCA	Pericytes
CTCTCGATCTTAGCCC	Microglia
CTCTGGTAGCATATGA	Pericytes
CTCTGGTAGCGAGGAG	InhibNeuron
CTCTGGTAGCGGCTCT	ExciteL23
CTCTGGTAGCTAGAGC	COPs
CTCTGGTCACGGAAGT	ExciteL23
CTCTGGTGTCACCGAC	MOLs
CTCTGGTTCGATGCTA	InhibNeuron
CTCTGGTTCGCGTCGA	ExciteL6
CTCTGGTTCGTAGTCA	MOLs
CTGAATGAGGACAACC	Astrocytes
CTGAATGCAGACCTGC	Microglia
CTGAATGCATAGACTC	ExciteL4
CTGAATGTCGCCCAGA	MOLs
CTGAATGTCTCCCATG	ExciteL6
CTGAGCGAGATGAACT	MOLs
CTGAGCGAGGCATCGA	Astrocytes
CTGAGCGCAAGTGATA	Microglia
CTGAGCGCAATTTCCT	OPCs
CTGAGCGCACAAAGTA	OPCs
CTGAGCGGTAGAATGT	OPCs
CTGAGCGTCCCAACTC	ExciteL6
CTGAGCGTCTATCCAT	ExciteL4
CTGAGGCAGGCCCACT	OPCs
CTGAGGCAGGCTCTAT	ExciteL4
CTGAGGCAGTCGAAAT	ExciteL6
CTGAGGCCAAGGCAAC	Microglia
CTGAGGCCAGGCATTT	ExciteL4
CTGAGGCGTGTTAAAG	ExciteL4
CTGAGGCGTTGCATGT	ExciteL4
CTGATCCAGGTTACCT	Microglia
CTGATCCCAGTGCCTG	COPs
CTGATCCGTAAGCAAT	ExciteL6
CTGATCCGTTATGTGC	Microglia
CTGATCCGTTTCGACA	ExciteL4
CTGATCCTCTCCCATG	ExciteL6
CTGATCCTCTGTCAGA	Microglia
CTGATCCTCTGTGTGA	MOLs
CTGCAGGAGATGCTAA	ExciteL4
CTGCAGGAGCTACTGT	Astrocytes
CTGCAGGAGGCTATCT	MOLs
CTGCAGGCAATCGCCG	OPCs
CTGCAGGCAGCTAACT	MOLs
CTGCAGGCATGAGATA	ExciteL23
CTGCAGGGTGAACGGT	Microglia
CTGCAGGGTTGGGTAG	MOLs
CTGCAGGTCCCAGTGG	MOLs
CTGCATCAGAATCTAG	MOLs
CTGCATCAGGCCTAAG	Pericytes
CTGCATCAGTATGACA	Microglia
CTGCATCCAACTACGT	ExciteL4
CTGCATCCAATAAGGT	Astrocytes
CTGCATCCAATAGTCC	MOLs
CTGCATCCACTTGGGC	Astrocytes
CTGCATCCAGCGTTTA	ExciteL4
CTGCATCGTCATAAAG	ExciteL23
CTGCATCTCGCTAGCG	ExciteL23
CTGCCATCAATAACGA	ExciteL4
CTGCCATCAGCGTGAA	Microglia
CTGCCATGTGAGCCAA	Microglia
CTGCCATTCGCAGAGA	ExciteL6
CTGCCTACAGCGTATT	MOLs
CTGCCTACAGGATGAC	ExciteL5
CTGCCTAGTCCTCCAT	ExciteNP
CTGCCTAGTGAATGTA	ExciteL23
CTGCCTATCACGAACT	Astrocytes
CTGCCTATCGGTCTAA	Microglia
CTGCGAGCAAGGCCTC	InhibNeuron
CTGCGAGTCATCGCTC	MOLs
CTGCGAGTCCGAGTGC	MOLs
CTGCGAGTCGCCAGAC	ExciteL6
CTGCTCAAGCACTTTG	Astrocytes
CTGCTCAAGGAACGTC	MOLs
CTGCTCAAGGCATCGA	Astrocytes
CTGCTCAAGTTGCATC	Astrocytes
CTGCTCACAAGACTGG	Microglia
CTGCTCACACTGGAAG	ExciteL4
CTGCTCATCCGAGATT	Pericytes
CTGCTCATCGCGGTAC	MOLs
CTGGACGAGGATCATA	Microglia
CTGGACGAGTACAGAT	ExciteL4
CTGGACGGTAGAGATT	ExciteL6
CTGGACGGTAGTTCCA	ExciteL4
CTGGACGGTTAGGGAC	ExciteL5
CTGGACGTCCTGGGAC	ExciteL6
CTGGACGTCGCTGATA	ExciteL4
CTGGCAGAGGTGCATG	Endo
CTGGCAGCAGCAGAAC	Microglia
CTGGCAGCATAGGTTC	OPCs
CTGGCAGCATTATGCG	ExciteL4
CTGGCAGGTCGATTCA	ExciteL23
CTGGCAGTCTCCGAAA	ExciteL6
CTGGTCTAGTAAGACT	Endo
CTGGTCTCACAGAGAC	MOLs
CTGGTCTCAGTGGGTA	Astrocytes
CTGGTCTCATAGGCGA	ExciteL4
CTGGTCTGTTACGCCG	ExciteL6
CTGGTCTGTTCAAAGA	ExciteL4
CTGGTCTTCAGCCTTC	Microglia
CTGGTCTTCTGAGAAA	Microglia
CTGTACCCAAACCATC	ExciteL4
CTGTACCCAGATCCAT	OPCs
CTGTACCCATTCTCCG	Macrophages
CTGTACCGTCCACTTC	ExciteL5
CTGTACCTCACTCGAA	Microglia
CTGTAGAAGTTAGAAC	ExciteL4
CTGTAGAAGTTGGCTT	Microglia
CTGTAGACAAGCCCAC	ExciteL4
CTGTAGAGTAGTGATA	ExciteL6
CTGTATTAGAGTATAC	Astrocytes
CTGTATTAGGTCGTCC	NIPCs
CTGTATTCAACAGCTT	ExciteL23
CTGTATTCACGATTCA	ExciteNP
CTGTATTGTCCAAAGG	ExciteL4
CTGTATTGTCTCTCTG	Microglia
CTGTCGTAGGTTCAGG	Astrocytes
CTGTCGTAGGTTCTTG	MOLs
CTGTCGTAGTGCTCGC	Astrocytes
CTGTCGTCAACTGATC	Astrocytes
CTGTCGTCAGCTGAAG	Microglia
CTGTCGTGTTTACCTT	ExciteL5
CTGTCGTTCTGAATCG	ExciteL4
CTGTGAAAGATTGCGG	MOLs
CTGTGAAAGCGATGCA	NIPCs
CTGTGAAAGGTCACTT	ExciteL5
CTGTGAACAAGTGGCA	OPCs
CTGTGAACAGGTTCGC	Microglia
CTGTGAACATCTTCGC	ExciteL4
CTGTGAATCAAGCCGC	ExciteL23
CTGTGAATCACAATGC	ExciteL4
CTGTGGGAGAAATTCG	OPCs
CTGTGGGAGGGTCAAC	MOLs
CTGTGGGCAACCGATT	OPCs
CTGTGGGCACTGCATA	OPCs
CTGTGGGCAGACACAG	ExciteNP
CTGTGGGCATCCGGCA	MOLs
CTGTGGGCATGACGGA	COPs
CTGTGGGTCTCATTTG	ExciteL23
CTTACCGAGTCACTGT	Microglia
CTTACCGCAATGCTCA	ExciteL4
CTTACCGGTGGATACG	Astrocytes
CTTACCGTCCGAGCTG	ExciteNP
CTTACCGTCTATCGGA	Microglia
CTTACCGTCTGTACAG	Microglia
CTTAGGACATCTCAAG	Microglia
CTTAGGAGTCTGTGCG	Microglia
CTTAGGATCATCCTGC	Astrocytes
CTTCAATAGGACGCTA	MOLs
CTTCAATCACCAAAGG	Microglia
CTTCAATCACGAGGTA	MOLs
CTTCAATGTACGACTT	Microglia
CTTCAATGTTCAATCG	Astrocytes
CTTCAATTCGCGCTGA	COPs
CTTCCGAAGGTTGGAC	Astrocytes
CTTCCGAAGTACTGTC	Microglia
CTTCCGAAGTATTAGG	ExciteL4
CTTCCGACAGTATACC	Microglia
CTTCCGACATAGCTGT	Microglia
CTTCCGAGTACGACAG	ExciteL4
CTTCCGAGTAGGACCA	ExciteNP
CTTCCGATCACAGAGG	OPCs
CTTCCTTCAGCTGTGC	MOLs
CTTCCTTGTATAGGGC	Microglia
CTTCCTTTCTATGTGG	Microglia
CTTCGGTGTCGTACAT	OPCs
CTTCGGTGTGATAGAT	ExciteL6
CTTCGGTGTGGTAATA	Microglia
CTTCGGTTCCAATGCA	ExciteL4
CTTCTAAAGGGAGGGT	InhibNeuron
CTTCTAAAGTACAACA	MOLs
CTTCTAACAAGTGTCT	ExciteL4
CTTCTAACAATCGCGC	Microglia
CTTCTAACACAGTGTT	ExciteL4
CTTCTAACACGGCTAC	MOLs
CTTCTAACAGATACCT	MOLs
CTTCTAAGTGGTCTCG	ExciteL4
CTTCTAAGTTTCTATC	OPCs
CTTCTAATCAGAACCT	Astrocytes
CTTCTAATCATCGCTC	MOLs
CTTCTAATCCTTATAC	Astrocytes
CTTCTAATCGAATGCT	ExciteL6
CTTCTCTAGAAGCGAA	Microglia
CTTCTCTCACGCGTGT	InhibNeuron
CTTCTCTGTAGAGTTA	ExciteL6
CTTCTCTGTTCGGACC	ExciteNP
CTTCTCTTCAAACCCA	ExciteL6
CTTGAGAAGGATGAGA	Microglia
CTTGAGAAGTCGGGAT	ExciteL4
CTTGAGACAAAGCTCT	MOLs
CTTGAGAGTAGTCCTA	Astrocytes
CTTGAGAGTCACTTCC	Astrocytes
CTTGAGATCGGTAAGG	MOLs
CTTGATTAGCACACAG	OPCs
CTTGATTAGCTACTAC	Astrocytes
CTTGATTCAAGCCCAC	ExciteNP
CTTGATTCACCCTCTA	ExciteL4
CTTGATTCATCGCTCT	COPs
CTTGATTGTTGCCGAC	ExciteL4
CTTTCAAAGATTCGAA	ExciteL4
CTTTCAAAGGAAACGA	NIPCs
CTTTCAAAGTCATCGT	OPCs
CTTTCAACACCATAAC	ExciteL4
CTTTCAACAGACACAG	OPCs
CTTTCAAGTCGGTGTC	ExciteL23
CTTTCAATCAGCTCTC	ExciteNP
CTTTCAATCATCACAG	MOLs
CTTTCAATCCGAAGGA	OPCs
CTTTCAATCTGGCCAG	OPCs
CTTTCGGAGAGCCCAA	Microglia
CTTTCGGAGCAATAAC	ExciteL4
CTTTCGGAGGACTATA	MOLs
CTTTCGGAGGTAGGCT	OPCs
CTTTCGGCAAGTCCAT	ExciteL6
CTTTCGGCACCGTCTT	MOLs
CTTTCGGCACGCTGCA	MOLs
CTTTCGGGTCCAGCGT	Microglia
CTTTCGGGTCGCACGT	ExciteL6
CTTTCGGGTCGGCCTA	ExciteNP
CTTTCGGGTCTGTGGC	MOLs
CTTTCGGGTGAATTGA	Astrocytes
CTTTCGGGTGTTAAAG	ExciteL4
CTTTCGGTCCATAAGC	MOLs
CTTTCGGTCTTGCGCT	MOLs
GAAACCTAGCGTGAAC	Microglia
GAAACCTAGGCCTGAA	Astrocytes
GAAACCTCAGCGCTTG	ExciteL6
GAAACCTCATCAGTGT	COPs
GAAACCTGTTGCATTG	MOLs
GAAATGAAGTCGCGAA	OPCs
GAAATGACACATGTTG	OPCs
GAAATGAGTCATAACC	ExciteL4
GAAATGAGTCATAGTC	OPCs
GAAATGAGTTACAGCT	Microglia
GAAATGATCACTACGA	MOLs
GAAATGATCAGCGTCG	MOLs
GAAATGATCCACAAGT	ExciteL4
GAAATGATCCACCTGT	Astrocytes
GAAATGATCCCTCGAT	MOLs
GAACACTAGAGCTTTC	Microglia
GAACACTAGCGGTAAC	Microglia
GAACACTCACCTCAGG	MOLs
GAACACTGTTGTCATG	ExciteL6
GAACACTTCCGAAATC	MOLs
GAACGTTAGAAGTATC	InhibNeuron
GAACGTTAGAGCACTG	Astrocytes
GAACGTTAGCACTCTA	OPCs
GAACGTTAGCAGTACG	OPCs
GAACGTTAGGACACTG	NIPCs
GAACGTTAGTCCTACA	Astrocytes
GAACGTTCAAGCGGAT	MOLs
GAACGTTGTAGATCCT	OPCs
GAACGTTGTCAGATTC	Astrocytes
GAACGTTGTGTCGATT	MOLs
GAACGTTGTTACACAC	InhibNeuron
GAACGTTGTTGGTACT	ExciteL6
GAACGTTGTTTGCAGT	OPCs
GAACGTTTCCATAGGT	Astrocytes
GAACTGTCAAATTAGG	Astrocytes
GAACTGTGTGGTCTTA	ExciteL23
GAACTGTGTTACGGAG	Microglia
GAACTGTTCATCACCC	MOLs
GAACTGTTCGTCTCAC	ExciteL5
GAACTGTTCTCGTGGG	Microglia
GAAGAATAGATTCGAA	ExciteL4
GAAGAATCAAGAAATC	MOLs
GAAGAATCACAGAGCA	ExciteL4
GAAGAATGTCGTGATT	Microglia
GAAGAATTCGTGGCTG	NIPCs
GAAGAATTCTCCAATT	ExciteL6
GAAGCCCAGCAGTAAT	OPCs
GAAGCCCAGTCTACCA	OPCs
GAAGCCCGTTTACGAC	Microglia
GAAGCCCTCAGGGTAG	ExciteL4
GAAGCCCTCGGTCACG	OPCs
GAAGCCCTCTACGGTA	ExciteL23
GAAGCCCTCTGAGAGG	ExciteL4
GAAGCGAAGCATACTC	ExciteL23
GAAGCGAAGTCTTGGT	ExciteL4
GAAGCGAAGTGAGGTC	Astrocytes
GAAGCGACAAAGCGTG	MOLs
GAAGCGACAAAGGCTG	Microglia
GAAGCGACACAAACGG	Astrocytes
GAAGCGAGTACCTGTA	ExciteL4
GAAGCGAGTATTGAGA	Astrocytes
GAAGCGATCCATTGCC	ExciteNP
GAAGGACAGAGCCGTA	Microglia
GAAGGACCAAGTAGTA	ExciteL5
GAAGGACCACATTACG	ExciteL6
GAAGGACCACGACTAT	ExciteL6
GAAGGACCATGTCGTA	ExciteL4
GAAGGACTCGATGCAT	Astrocytes
GAAGGACTCTAGAGCT	Astrocytes
GAAGGGTAGGATATGT	OPCs
GAAGGGTAGTGGTGAC	Microglia
GAAGGGTAGTTGGCGA	Astrocytes
GAAGGGTCAAGCGGAT	ExciteL6
GAAGGGTCAGTGTATC	ExciteL6
GAAGGGTCATGAGTAA	ExciteL5
GAAGGGTCATGATCTG	Microglia
GAAGGGTGTAGAGGAA	Microglia
GAAGGGTGTAGGAGGG	Astrocytes
GAAGGGTGTCCTGAAT	Astrocytes
GAAGGGTGTTGGAGGT	Microglia
GAAGTAAAGGGCCAAT	Astrocytes
GAAGTAACACAGCCTG	MOLs
GAAGTAACACTGCGTG	ExciteL23
GAAGTAAGTAGACGGT	ExciteL4
GAAGTAATCTTTCCAA	MOLs
GAATAGAAGCTGTGCC	ExciteL6
GAATAGAAGTAACAGT	ExciteL4
GAATAGACACAGTCCG	ExciteL23
GAATAGACACGGATCC	COPs
GAATAGACAGCAGGAT	OPCs
GAATAGACATCCGAAT	ExciteL23
GAATAGAGTCCACTCT	OPCs
GAATAGAGTGAGATTA	Microglia
GAATAGATCTGAGAGG	ExciteL4
GAATCACAGCACACAG	ExciteL23
GAATCACAGCTAGCCC	Microglia
GAATCACAGCTATCTG	ExciteL4
GAATCACAGGCGAAGG	ExciteL4
GAATCACCAGTTAGAA	ExciteL4
GAATCACCATAACCCA	Macrophages
GAATCACGTTGCATCA	Microglia
GAATCGTCAGATGCGA	MOLs
GAATCGTGTGGGAGAG	Microglia
GAATCGTGTGTTAGCT	OPCs
GAATCGTTCGATTCCC	InhibNeuron
GACACGCAGGATCACG	NIPCs
GACACGCAGGGAGATA	Microglia
GACACGCAGGGCGAAG	COPs
GACACGCAGGTTGTTC	ExciteL4
GACACGCGTACAACGG	ExciteL6
GACACGCGTCGAATGG	Microglia
GACACGCGTGAGGAAA	ExciteL5
GACAGCCAGAGTTCGG	OPCs
GACAGCCTCTCATGCC	COPs
GACATCAAGACCAAGC	InhibNeuron
GACATCAAGCACTAAA	OPCs
GACATCACACTTCCTG	Astrocytes
GACATCAGTAACGCGA	Microglia
GACATCAGTCAAAGCG	Microglia
GACATCAGTCTAGGCC	ExciteL23
GACATCAGTGCTGTCG	ExciteNP
GACATCAGTTGCAAGG	NIPCs
GACATCATCCCGAGGT	MOLs
GACATCATCCGATGCG	MOLs
GACATCATCGACCCAG	InhibNeuron
GACATCATCGAGCACC	Microglia
GACCAATAGCGTGAGT	OPCs
GACCAATAGGTCCCTG	COPs
GACCAATCAAATGGTA	Microglia
GACCAATCAAGTGGAC	Microglia
GACCAATCACTCTAGA	ExciteNP
GACCAATCACTTGACA	ExciteL6
GACCAATCAGTCGAGA	InhibNeuron
GACCAATGTCCACATA	Astrocytes
GACCCAGAGAGTCTTC	Microglia
GACCCAGAGTAACCTC	MOLs
GACCCAGAGTGCTCAT	Microglia
GACCCAGCAATTTCGG	ExciteL23
GACCCAGCAGTATTCG	Microglia
GACCCAGCATGGTGGA	Microglia
GACCCAGGTGTCACAT	MOLs
GACCCAGTCCAGTGTA	OPCs
GACCCAGTCCTATTTG	ExciteL4
GACCCTTAGGAAGAAC	ExciteL6
GACCCTTAGTCTACCA	Endo
GACCCTTCACATCATG	Macrophages
GACCCTTCATGGAGAC	ExciteL4
GACCCTTGTAGCCAGA	ExciteL6
GACCCTTGTGAGCAGT	InhCajalRetzius
GACCCTTTCATAGCAC	OPCs
GACCCTTTCTACTTCA	OPCs
GACCGTGAGAGCTTTC	MOLs
GACCGTGAGTAGAATC	Astrocytes
GACCGTGAGTATCTGC	ExciteNP
GACCGTGCAACACGAG	InhibNeuron
GACCGTGCAGTGCGCT	Microglia
GACCGTGCATACAGCT	Microglia
GACCGTGCATCAACCA	Microglia
GACCGTGTCCATCTCG	MOLs
GACCGTGTCGGAGATG	ExciteL4
GACCGTGTCTGGGCCA	Microglia
GACCGTGTCTTAAGGC	OPCs
GACCGTGTCTTCCTAA	Microglia
GACCTTCAGTGACACG	Microglia
GACCTTCCACAACGAG	OPCs
GACCTTCGTCGCATCG	Microglia
GACCTTCTCCCGAGTG	Microglia
GACGCTGCAATACCTG	InhibNeuron
GACGCTGGTAGCTGAG	OPCs
GACGCTGGTCTTGCGG	ExciteL23
GACGCTGGTGGAATGC	COPs
GACGTTAAGCGACCCT	Microglia
GACGTTAAGGACGCTA	ExciteL4
GACGTTAAGGATCATA	Astrocytes
GACGTTACAAGTGCTT	InhibNeuron
GACGTTACAAGTTTGC	OPCs
GACGTTACACGCAAAG	ExciteL6
GACGTTACACGGAAGT	Microglia
GACGTTACAGACACCC	ExciteL4
GACGTTACAGAGAAAG	OPCs
GACGTTACAGTTGTTG	OPCs
GACGTTAGTCCGGATC	Ependymal
GACGTTAGTGAGCGAT	ExciteNP
GACGTTATCATCTCTA	Microglia
GACGTTATCATTGAGC	MOLs
GACGTTATCCGTGTAA	ExciteL4
GACGTTATCGCTGTCT	Ependymal
GACTATGAGCGCATCC	ExciteL23
GACTATGCAAGCGAGT	ExciteL23
GACTATGCACAAAGCG	Microglia
GACTATGTCACTAGCA	ExciteL4
GACTATGTCCATCACC	ExciteL4
GACTATGTCGCACTCT	Astrocytes
GACTCAAAGACTACCT	OPCs
GACTCAACAACTGTGT	ExciteL4
GACTCAACATGCAGGA	ExciteL6
GACTCAAGTAATTAGG	Microglia
GACTCAAGTATTAAGG	Microglia
GACTCAAGTTCTATCT	Microglia
GACTCAAGTTGCCAAT	MOLs
GACTCAATCGCTGACG	Microglia
GACTCTCAGACTCAAA	MOLs
GACTCTCAGGTCATTC	Microglia
GACTCTCCAGGCCTGT	Astrocytes
GACTCTCCATTGGGAG	Microglia
GACTCTCGTAGAGATT	MOLs
GACTCTCGTTGTGCAT	ExciteNP
GACTCTCTCTCCATAT	OPCs
GACTCTCTCTCGTCGT	Astrocytes
GACTGATAGTAAATGC	MOLs
GACTGATCACTGTGTA	ExciteL4
GACTGATCATTAAGCC	Endo
GACTGATGTTTCGTAG	Microglia
GACTGATTCTGTGCTC	OPCs
GACTTCCAGTTCATCG	OPCs
GACTTCCCATTGCAAC	MOLs
GACTTCCGTGCAGTGA	Microglia
GACTTCCTCATGAGGG	Macrophages
GACTTCCTCGCGTTTC	ExciteL23
GACTTCCTCTCTCGAC	MOLs
GAGAAATAGACCAAGC	ExciteL6
GAGAAATAGCACCCAC	Endo
GAGAAATAGGCACGAT	ExciteL6
GAGAAATAGTACCCTA	OPCs
GAGAAATAGTGGATTA	MFOLs
GAGAAATCACCAGTTA	Microglia
GAGAAATCAGGTAGTG	MOLs
GAGAAATGTAGAGGAA	MOLs
GAGAAATGTCTCGCGA	Macrophages
GAGAAATGTTCAGCTA	InhibNeuron
GAGAAATTCGCCATAA	ExciteL23
GAGACCCAGCTGTCCG	OPCs
GAGACCCAGGTTCTTG	Microglia
GAGACCCCAGACCCGT	MOLs
GAGACCCCAGCGCTTG	ExciteL4
GAGACCCGTAGTACGG	MOLs
GAGACCCGTGCTGCAC	Microglia
GAGACCCGTGTTTCTT	Astrocytes
GAGACCCGTTTACTGG	MOLs
GAGACCCTCTGGCCTT	Microglia
GAGACCCTCTTCCTAA	ExciteL6
GAGACTTAGTTGAAGT	Microglia
GAGACTTCAAGCGCTC	OPCs
GAGACTTCACTAAACC	MOLs
GAGACTTCAGCGACAA	ExciteL6
GAGACTTGTACCGGAA	ExciteL4
GAGACTTGTATAGGAT	Astrocytes
GAGACTTGTCCTTTGC	Astrocytes
GAGACTTGTGGCTTAT	Microglia
GAGACTTGTTAGTCGT	Microglia
GAGACTTTCTTGGCTC	ExciteL23
GAGAGGTCAACAGTGG	NIPCs
GAGAGGTGTCCAACGC	MOLs
GAGAGGTGTGATTGGG	ExciteL4
GAGAGGTGTTTGCCGG	OPCs
GAGAGGTGTTTGGAGG	ExciteL4
GAGAGGTTCAATGCAC	Astrocytes
GAGAGGTTCCTATTTG	NIPCs
GAGAGGTTCGACCATA	MOLs
GAGATGGAGTTCATGC	NIPCs
GAGATGGCAGACATCT	ExciteL4
GAGATGGCATGCACTA	COPs
GAGATGGGTCCAAGAG	Microglia
GAGATGGGTTCCCACT	ExciteL6
GAGATGGGTTGCGAAG	ExciteL23
GAGATGGTCCATTGTT	ExciteL6
GAGCCTGCACTGGACC	Microglia
GAGCCTGCAGTCGCAC	Microglia
GAGCCTGGTAGAATGT	Astrocytes
GAGCCTGGTCCAGAAG	ExciteL6
GAGCCTGTCGACACTA	Microglia
GAGCCTGTCTCTAAGG	Microglia
GAGCTGCAGTATCTGC	ExciteL5
GAGCTGCAGTGAGTTA	ExciteL6
GAGCTGCCACCGGTCA	Astrocytes
GAGCTGCGTGACATCT	InhibNeuron
GAGCTGCGTGTTCCAA	ExciteL4
GAGCTGCTCAAACCCA	Macrophages
GAGCTGCTCTCGGTAA	ExciteL4
GAGGCAAAGGACAAGA	ExciteL4
GAGGCAAAGGAGAGTA	OPCs
GAGGCAAAGTTCCAGT	ExciteL4
GAGGCAACACCTAAAC	COPs
GAGGCAACAGGCTTGC	MOLs
GAGGCAACAGTTGTCA	Astrocytes
GAGGCAAGTATCGCAT	InhibNeuron
GAGGCAAGTGAGAGGG	Astrocytes
GAGGCCTGTGAGACGT	MOLs
GAGGCCTGTGCATGTT	OPCs
GAGGCCTTCACGACTA	InhibNeuron
GAGGGATCAATGTCTG	ExciteL23
GAGGGATCACGGCCAT	ExciteL23
GAGGGATCATATGAAG	OPCs
GAGGGATGTAGTCACT	InhibNeuron
GAGGGATGTGTGTGGA	ExciteL4
GAGGGATTCAATCCAG	OPCs
GAGGGATTCATCAGTG	Endo
GAGGGATTCCCTCTCC	MOLs
GAGGGATTCGCAATGT	ExciteL23
GAGGGATTCGGCTATA	MOLs
GAGGGTAAGTTGAAGT	MOLs
GAGGGTACAAGACCTT	MOLs
GAGGGTACAGAGGCAT	Microglia
GAGGGTAGTAATCAAG	ExciteL4
GAGGGTAGTACACGTT	ExciteL4
GAGTCATAGAATCGTA	ExciteL5
GAGTCATAGCCTGCCA	ExciteL4
GAGTCATAGTAGATCA	MOLs
GAGTCATCACTATGTG	ExciteL6
GAGTCATGTTGCGGCT	ExciteL4
GAGTCATTCCCATGGG	Pericytes
GAGTCATTCCTCTGCA	ExciteL4
GAGTCTAAGATGTTAG	Microglia
GAGTCTAAGCTTAGTC	ExciteL4
GAGTCTACAAAGCGTG	Microglia
GAGTCTACAATTCTTC	Astrocytes
GAGTCTACACCTAAAC	OPCs
GAGTCTACAGCCTATA	InhibNeuron
GAGTCTAGTAGGAGTC	ExciteL23
GAGTCTAGTCCCACGA	MOLs
GAGTCTATCAGTGATC	OPCs
GAGTGAGAGGCTATCT	Endo
GAGTGAGAGGTATTGA	NIPCs
GAGTGAGAGTAGCCAG	InhibNeuron
GAGTGAGCAAATCGGG	ExciteL6
GAGTGAGGTATACAGA	Astrocytes
GAGTGAGTCAAGTAAG	Microglia
GAGTGTTCAAGAAACT	InhibNeuron
GAGTGTTCACATAACC	OPCs
GAGTGTTGTGTGTACT	MOLs
GAGTGTTTCAGGACGA	MOLs
GAGTTACAGAAGGCTC	Astrocytes
GAGTTACAGATTCGCT	Endo
GAGTTACAGCACTCAT	Endo
GAGTTACAGCGGGTAT	Endo
GAGTTACAGGCCACTC	Microglia
GAGTTACAGGTTGTTC	Pericytes
GAGTTACCAGAGTTCT	OPCs
GAGTTACGTTAGAGTA	InhibNeuron
GAGTTACTCCTGGGAC	ExciteL4
GAGTTGTAGAGAGGTA	OPCs
GAGTTGTAGCAGGCAT	ExciteL4
GAGTTGTAGCGATGGT	ExciteL4
GAGTTGTCACAAATAG	Astrocytes
GAGTTGTGTTTACGTG	ExciteL6
GAGTTGTTCCCACAGG	MOLs
GAGTTGTTCCTTCTTC	Microglia
GAGTTGTTCCTTTGAT	Microglia
GAGTTGTTCGAAACAA	Microglia
GAGTTGTTCGAACCTA	Astrocytes
GAGTTGTTCGCTTGAA	ExciteL4
GAGTTGTTCGGAGTGA	COPs
GAGTTGTTCTCTGACC	ExciteL6
GAGTTTGAGACTTCAC	Astrocytes
GAGTTTGAGTGCGCTC	Astrocytes
GAGTTTGAGTTCCTGA	ExciteL5
GAGTTTGCAATATCCG	ExciteL4
GAGTTTGGTTCTCAGA	Microglia
GAGTTTGGTTGACTAC	ExciteL6
GAGTTTGGTTGCTCGG	MOLs
GAGTTTGTCGTAGTCA	ExciteL6
GATAGAAAGGATCACG	ExciteL5
GATAGAACAACGCATT	MOLs
GATAGAACAGCGTGAA	InhibNeuron
GATAGAAGTCATGACT	ExciteL23
GATAGAATCCACAGCG	Microglia
GATAGAATCTGGAGAG	OPCs
GATAGCTAGCATCTTG	ExciteL6
GATAGCTAGCCGGATA	ExciteL4
GATAGCTCAATTGCGT	ExciteL5
GATAGCTCACGCTGTG	COPs
GATAGCTCATCGCCTT	OPCs
GATAGCTGTGCTATTG	Microglia
GATAGCTGTGGAACAC	ExciteL6
GATAGCTTCAGCAATC	OPCs
GATAGCTTCCATTCAT	ExciteL4
GATAGCTTCCCACAGG	Fibroblasts
GATCACAAGATGGTAT	ExciteL4
GATCACAAGTAAGAGG	Astrocytes
GATCACACAATACGAA	Microglia
GATCACACAATTTCTC	InhibNeuron
GATCACACAGTCAGTT	Microglia
GATCACACATCCTTCG	Astrocytes
GATCACAGTTGGGCCT	Microglia
GATCAGTAGAGAGGTA	ExciteNP
GATCAGTAGCAATAGT	Astrocytes
GATCAGTAGGCTAGCA	MOLs
GATCAGTCAAGAAACT	Microglia
GATCAGTCACAACGTT	Microglia
GATCAGTGTCGCATGC	Microglia
GATCAGTTCGAAGAAT	Astrocytes
GATCATGAGCAGCGAT	ExciteL4
GATCATGAGTAGTGCG	Astrocytes
GATCATGGTCAATGGG	ExciteL6
GATCCCTAGACCATAA	Endo
GATCCCTCAATCGCCG	MOLs
GATCCCTCACACGTGC	ExciteL23
GATCCCTCACTCAAGT	Macrophages
GATCCCTCACTTCCTG	ExciteL6
GATCCCTGTACCGGCT	ExciteL4
GATCCCTGTACGCTTA	MOLs
GATCCCTGTCCAATCA	ExciteL6
GATCCCTTCATGCCGG	MOLs
GATCCCTTCATTCATC	InhibNeuron
GATCCCTTCGGCTTCT	ExciteL23
GATCGTAAGGCATGGT	Microglia
GATCGTACAAGAGATT	MOLs
GATCGTACACGAGGTA	ExciteL4
GATCGTACAGTAACGG	MOLs
GATCGTACATCGTTCC	InhibNeuron
GATCGTACATTGGCAT	COPs
GATCGTAGTGCTCCGA	Astrocytes
GATCGTATCTATTCGT	ExciteL6
GATCGTATCTCACGAA	ExciteL6
GATGACTCAACCGACC	Microglia
GATGACTCAACTCGAT	ExciteL6
GATGACTCACTATGTG	NIPCs
GATGACTCAGACAATA	NIPCs
GATGACTGTGCATCTA	MOLs
GATGACTTCATGGTAC	ExciteL4
GATGACTTCCTTCGAC	OPCs
GATGACTTCTGCGGCA	Microglia
GATGAGGAGGATGAGA	ExciteL23
GATGAGGCAAAGCAAT	ExciteL4
GATGAGGCAATGCAAA	Microglia
GATGAGGCAGTCGAGA	MOLs
GATGAGGCATAGTCAC	InhibNeuron
GATGAGGCATGACTAC	Macrophages
GATGAGGGTCGAGCAA	ExciteL5
GATGAGGGTCTTGTCC	ExciteL4
GATGAGGTCACCCTTG	COPs
GATGAGGTCCATCTCG	Microglia
GATGAGGTCTTAATCC	Astrocytes
GATGATCAGTAGTCCT	Microglia
GATGATCTCGCCATAA	ExciteL4
GATGATCTCTTTCGAT	NIPCs
GATGCTAAGATGTTCC	ExciteL23
GATGCTACATCTTAGG	MOLs
GATGCTAGTATCGTGT	ExciteL4
GATGCTAGTTAAACCC	ExciteL4
GATGCTAGTTTCCCAC	InhibNeuron
GATGCTATCCCGTGAG	ExciteL6
GATGCTATCTGCGTCT	MOLs
GATGGAGCACCCTAAA	MOLs
GATGGAGCAGGACAGT	Astrocytes
GATGGAGCATTGCCTC	OPCs
GATGGAGGTGTGACCC	ExciteL6
GATGGAGTCTCATGGA	ExciteL6
GATGTTGAGCACGTCC	ExciteL4
GATGTTGAGGAAAGAC	Microglia
GATGTTGAGGTATAGT	ExciteL4
GATGTTGCACATTACG	ExciteL6
GATGTTGCAGCATTGT	Microglia
GATGTTGCATGCAGCC	Microglia
GATGTTGGTGATAGTA	ExciteL4
GATGTTGTCGACCAAT	ExciteL6
GATTCGAAGTCGAAGC	ExciteL4
GATTCGACAAACCATC	MOLs
GATTCGAGTCCACTTC	MOLs
GATTCGAGTTACCCAA	COPs
GATTCGATCACCCTGT	MOLs
GATTCGATCGCTATTT	Microglia
GATTCGATCTCTCTTC	ExciteL4
GATTCTTAGAATCCCT	Astrocytes
GATTCTTAGCCTCGTG	ExciteL6
GATTCTTGTACTGGGA	ExciteL6
GATTCTTGTAGGTACG	ExciteL23
GATTCTTGTATGTCAC	Microglia
GATTCTTTCCACAGCG	ExciteL4
GATTGGTAGCCTAACT	MOLs
GATTGGTAGCTGGAGT	ExciteL6
GATTGGTAGTCATGAA	Microglia
GATTGGTCAATTCGTG	Astrocytes
GATTGGTCACCATAAC	InhibNeuron
GATTGGTGTCTGTCCT	ExciteL6
GATTGGTGTGACATCT	ExciteL4
GATTGGTTCCGAGCTG	ExciteL6
GATTGGTTCCTCACTG	MOLs
GATTGGTTCTGGGAGA	MOLs
GATTTCTAGGCATTTC	Astrocytes
GATTTCTAGTACTGTC	OPCs
GATTTCTCAAAGTGTA	ExciteL5
GATTTCTCAACGGCCT	ExciteL6
GATTTCTCAACTTCTT	MOLs
GATTTCTCAGCATGCC	OPCs
GATTTCTGTGTCCTAA	InhibNeuron
GATTTCTTCCTTCACG	ExciteNP
GCAACATAGGCAGCTA	Astrocytes
GCAACATCAACCGGAA	Microglia
GCAACATCAAGAGCTG	OPCs
GCAACATGTGGCTGCT	Astrocytes
GCAACATGTTGTTGCA	OPCs
GCAACATTCATAGAGA	Pericytes
GCAACATTCATTCTTG	Astrocytes
GCAACATTCCGGACGT	COPs
GCAACCGAGATTAGTG	MOLs
GCAACCGAGTCGGGAT	Pericytes
GCAACCGCACTGGAAG	Microglia
GCAACCGCACTTACAG	Microglia
GCAACCGCAGTTGGTT	Microglia
GCAACCGGTAACATCC	MOLs
GCAACCGGTACCTGTA	ExciteL4
GCAACCGGTTATCTTC	Microglia
GCAACCGGTTCAAGGG	MOLs
GCACATAAGGCGAACT	ExciteL6
GCACATAAGTCACGAG	Astrocytes
GCACATACACACACTA	Astrocytes
GCACATACACCCAATA	ExciteNP
GCACATACAGCTAACT	ExciteL6
GCACATATCCGTAGGC	InhibNeuron
GCACATATCGGCATTA	Microglia
GCACGGTCACGTGTGC	Microglia
GCACGGTGTAGCGCCT	Microglia
GCACGGTGTCCAAGAG	ExciteL5
GCACGGTGTTCGTAAC	COPs
GCACGGTTCCCAGGCA	OPCs
GCACGTGCAACTGCTA	ExciteL5
GCACGTGTCCCTGGTT	Microglia
GCACGTGTCTTCTGTA	MOLs
GCACTAAAGCATGCGA	ExciteL6
GCACTAAAGTTCGGTT	Microglia
GCACTAACAGACCTAT	Microglia
GCACTAAGTTACCTGA	OPCs
GCACTAATCCTCTGCA	MOLs
GCACTAATCTTCCTAA	ExciteNP
GCAGCCAAGGCTCTAT	MOLs
GCAGCCACACATACGT	OPCs
GCAGCCACAGATGCGA	ExciteL6
GCAGCCACAGTCGCTG	Microglia
GCAGCCACATCGATCA	MFOLs
GCAGCCAGTTGTACGT	ExciteL23
GCAGCTGAGACAAGCC	MOLs
GCAGCTGCACCTATCC	OPCs
GCAGCTGCAGGTATGG	Microglia
GCAGCTGCATGAGATA	Microglia
GCAGCTGGTCCTGGGT	InhibNeuron
GCAGCTGGTCGTATGT	ExciteL4
GCAGCTGTCCAACCAA	ExciteL6
GCAGGCTAGACAGCTG	OPCs
GCAGGCTAGGAGGGTG	ExciteL6
GCAGGCTCAAGCGCAA	OPCs
GCAGGCTCACACTTAG	Microglia
GCAGGCTTCACTGCTC	MOLs
GCAGGCTTCATATGGC	MOLs
GCAGGCTTCGCAATTG	ExciteL6
GCAGGCTTCGTTCTCG	OPCs
GCAGTTAAGTCGCGAA	ExciteNP
GCAGTTACAGCTACAT	InhibNeuron
GCAGTTACATGGCTAT	Microglia
GCAGTTAGTGGACTAG	ExciteL5
GCAGTTATCATATGGC	Astrocytes
GCAGTTATCCATAAGC	Microglia
GCATCGGAGGCCTTGC	ExciteL5
GCATCGGAGGTCCTGC	OPCs
GCATCGGCACAAACGG	InhibNeuron
GCATCGGCAGTGTGCC	MOLs
GCATCGGGTGTGCTTA	Microglia
GCATCGGGTTGCTCAA	ExciteL4
GCATCGGTCCGAGGCT	Microglia
GCATCGGTCGCAATTG	ExciteL23
GCATCGGTCTATCGGA	Microglia
GCATCTCAGCCATATC	Microglia
GCATCTCAGCGCGTTC	COPs
GCATCTCGTAGGACCA	MOLs
GCATCTCGTGATAGAT	ExciteL23
GCATCTCTCAGTGTGT	Astrocytes
GCATCTCTCCTGTAGA	Pericytes
GCATCTCTCGAACGCC	Astrocytes
GCATGATAGAAATCCA	ExciteL6
GCATGATTCAATCAGC	MOLs
GCATTAGCAAGAGTAT	ExciteL6
GCATTAGCAAGTACCT	Astrocytes
GCATTAGCACAGAGAC	ExciteL4
GCATTAGCAGGCCTGT	OPCs
GCATTAGGTGTTCGAT	Astrocytes
GCATTAGGTTAAGACA	OPCs
GCATTAGGTTGTGCCG	Microglia
GCATTAGTCGTTCGCT	Astrocytes
GCATTAGTCTGCCCTA	Astrocytes
GCCAACGAGAAATTGC	Microglia
GCCAACGAGACTCTAC	MOLs
GCCAACGAGGTAATCA	InhibNeuron
GCCAACGCATGAAGCG	OPCs
GCCAACGGTAACCCGC	Microglia
GCCAACGGTAGGACCA	ExciteL6
GCCAACGTCAAGATAG	Microglia
GCCAACGTCTGCTAGA	NIPCs
GCCAGCAAGAAATGGG	OPCs
GCCAGCAGTAGGGTAC	Pericytes
GCCAGCAGTCTGTAAC	MOLs
GCCAGCATCCTTGAAG	Astrocytes
GCCAGGTAGTATAACG	COPs
GCCAGGTCACCAGTTA	Microglia
GCCAGGTGTATCCCAA	MOLs
GCCAGGTGTCTAGATC	ExciteL4
GCCAGGTTCAGCTTCC	NIPCs
GCCAGGTTCGCCGTGA	Astrocytes
GCCAGTGAGGATAATC	MOLs
GCCAGTGCACAGTACT	ExciteL6
GCCAGTGCATTCCTAT	Microglia
GCCAGTGGTGATAGAT	ExciteL5
GCCAGTGGTGGTAATA	COPs
GCCAGTGGTGTCTTAG	ExciteL6
GCCAGTGGTTAAACCC	MOLs
GCCAGTGGTTAAGGAT	ExciteL4
GCCAGTGTCCCAGCGA	ExciteL4
GCCAGTGTCCTAGAGT	OPCs
GCCAGTGTCGAATCCA	Microglia
GCCAGTGTCGGCTGTG	InhibNeuron
GCCATGGAGGACTAAT	MOLs
GCCATGGAGGATTCCT	Microglia
GCCATGGAGGTTAGTA	MOLs
GCCATGGAGTCTTCCC	InhibNeuron
GCCATGGCAAGTCATC	MOLs
GCCATGGCAGCTTCCT	ExciteL6
GCCATGGGTACGAGTG	ExciteL6
GCCATGGGTCTCTCTG	Astrocytes
GCCATGGTCCTCTTTC	Microglia
GCCATGGTCGACATCA	Microglia
GCCATTCAGGTTATAG	Astrocytes
GCCATTCAGTGCAGCA	Microglia
GCCATTCCATGTGTCA	MOLs
GCCATTCGTGGTCTGC	InhibNeuron
GCCATTCTCGGATAAA	ExciteL23
GCCCAGAAGCAACCAG	ExciteL5
GCCCAGAAGCACTCCG	ExciteL4
GCCCAGAAGCTAGTTC	OPCs
GCCCAGACACAAACGG	Microglia
GCCCAGACAGGGATAC	Microglia
GCCCAGAGTACCCAGC	MOLs
GCCCAGAGTACCTATG	Astrocytes
GCCCAGAGTTACCCTC	NIPCs
GCCCAGATCAAAGACA	ExciteL23
GCCCAGATCCTAGCCT	ExciteL4
GCCCGAAAGCTGAGTG	ExciteL4
GCCCGAAAGGTATCTC	Microglia
GCCCGAACACTTGTCC	Microglia
GCCCGAAGTCTAATCG	COPs
GCCCGAAGTTAGGGAC	Macrophages
GCCCGAAGTTGAGGAC	Astrocytes
GCCCGAAGTTGGTACT	Astrocytes
GCCCGAATCCCTCAAC	Astrocytes
GCCCGAATCTGCGGCA	Pericytes
GCCGATGAGCAAGCCA	ExciteL5
GCCGATGAGCTACAAA	Microglia
GCCGATGCAACAAGTA	Microglia
GCCGATGCAACCGTAT	OPCs
GCCGATGGTTCTCCAC	ExciteL6
GCCGATGGTTGTCCCT	MOLs
GCCGATGTCAATCTTC	Pericytes
GCCGATGTCGAGATGG	ExciteL4
GCCGATGTCTCGCCTA	ExciteL6
GCCGATGTCTGGCCGA	Microglia
GCCGTGACAATGAAAC	ExciteL4
GCCGTGACAGCTTCCT	OPCs
GCCGTGACAGGTAGTG	MOLs
GCCGTGAGTACCACGC	MOLs
GCCGTGAGTCACATTG	Endo
GCCGTGATCCATCTGC	Microglia
GCCTGTTAGCAATTAG	ExciteL6
GCCTGTTAGCGAACTG	MOLs
GCCTGTTAGCTTTGTG	Microglia
GCCTGTTCAGTAGAGC	MOLs
GCCTGTTGTAAGTTGA	OPCs
GCCTGTTGTCGTTGCG	Microglia
GCCTGTTTCGTCCTTG	ExciteL4
GCGAGAAAGCTGGCTC	ExciteL4
GCGAGAAAGGTCGTCC	Microglia
GCGAGAACAGCTGCCA	ExciteL4
GCGAGAAGTCGGCTAC	ExciteL5
GCGAGAAGTGATCGTT	ExciteL4
GCGAGAATCCAATCTT	ExciteL6
GCGAGAATCCTTACCG	OPCs
GCGAGAATCGCTTACC	OPCs
GCGAGAATCTCGACGG	Microglia
GCGATCGAGGTGCATG	NIPCs
GCGATCGCAACAGAGC	ExciteL6
GCGATCGCACGACAGA	Microglia
GCGATCGCAGCATTGT	ExciteL4
GCGATCGGTTCCTACC	Microglia
GCGATCGTCGATTTCT	ExciteL4
GCGGAAAAGAAAGTCT	Microglia
GCGGAAAAGCTGGCTC	ExciteL6
GCGGAAAGTTCCGCTT	ExciteL4
GCGGAAAGTTCGAAGG	MOLs
GCGGAAAGTTGTAGCT	ExciteL4
GCGGAAATCAAGCCCG	MOLs
GCGGAAATCCCAGGCA	Microglia
GCGGAAATCGACCAAT	Microglia
GCGGATCAGTTAACGA	Microglia
GCGGATCCACCTCAGG	NIPCs
GCGGATCGTGTTTGCA	OPCs
GCGGATCGTTACGCCG	COPs
GCGGATCTCACGGACC	ExciteL23
GCGGATCTCATCTACT	ExciteL4
GCGTGCAAGTACCGGA	ExciteL23
GCGTGCAGTCTCAAGT	MOLs
GCGTGCAGTGTATACC	InhibNeuron
GCGTGCAGTTCAAACC	COPs
GCGTGCATCCGGACGT	MOLs
GCGTGCATCGGTCGAC	ExciteL4
GCGTGCATCTCAGTCC	MOLs
GCGTTTCAGCGCACAA	Microglia
GCGTTTCCAGATAAAC	ExciteL4
GCGTTTCCATAACAGA	MOLs
GCGTTTCGTGATACTC	ExciteL5
GCGTTTCTCCAGTTCC	ExciteL6
GCTACAAAGGTGCCTC	ExciteL4
GCTACAAAGTCTCGTA	ExciteL6
GCTACAACACAATCTG	MOLs
GCTACAACACATTGTG	ExciteL4
GCTACAACACGTCATA	Microglia
GCTACAACACTACCGG	MOLs
GCTACAACATCCTTGC	Microglia
GCTACAAGTCCCACGA	ExciteL4
GCTACAAGTGCAAGAC	Microglia
GCTACAATCCGCGAGT	Astrocytes
GCTACCTAGAATTCAG	ExciteL6
GCTACCTAGCTGTGCC	MOLs
GCTACCTAGGTACAAT	COPs
GCTACCTAGTATAGGT	Microglia
GCTACCTCAAACTAAG	ExciteL23
GCTACCTCAAATACAG	Pericytes
GCTACCTCAGTGGGTA	ExciteL4
GCTCAAAAGCGACCCT	Astrocytes
GCTCAAAAGTTGCCCG	Endo
GCTCAAACACAGCTGC	Microglia
GCTCAAACACGCGTCA	Microglia
GCTCAAACAGACGGAT	Microglia
GCTCAAACATTGGATC	Macrophages
GCTCAAAGTCCGGTGT	Microglia
GCTCAAATCACCGGTG	Microglia
GCTCAAATCACCTCTG	ExciteL4
GCTGAATAGACAACTA	NIPCs
GCTGAATAGGGTTTCT	InhibNeuron
GCTGAATCATTGCAAC	InhibNeuron
GCTGAATGTATGCGTT	OPCs
GCTGAATGTATTGAGA	ExciteL4
GCTGAATGTGATAGAT	ExciteL4
GCTGAATGTTAGAAGT	OPCs
GCTGAATTCATTGCTT	ExciteL4
GCTGAATTCGACCACG	ExciteL4
GCTGCAGAGAAACTAC	Astrocytes
GCTGCAGAGGCCTAGA	Macrophages
GCTGCAGCAAGCTGCC	ExciteL6
GCTGCAGGTTTCAGAC	Astrocytes
GCTGCAGTCCATTGCC	ExciteL6
GCTGGGTAGAGCCGTA	MOLs
GCTGGGTAGCACACAG	Astrocytes
GCTGGGTAGGTTTGAA	ExciteL6
GCTGGGTAGTCTGGTT	ExciteL4
GCTGGGTGTCACTCTC	Pericytes
GCTGGGTTCCGTCACT	Microglia
GCTGGGTTCGTTCCCA	Astrocytes
GCTTCACCAATCTAGC	Astrocytes
GCTTCACCATCATTGG	ExciteL4
GCTTCACGTGCTCTTC	MOLs
GCTTGGGAGGTCGCCT	ExciteL4
GCTTGGGAGGTTGCCC	MOLs
GCTTGGGCAAGTGGAC	MOLs
GCTTGGGCAGTCGAGA	Microglia
GCTTGGGGTTAATGAG	Microglia
GCTTGGGTCGAGATGG	Microglia
GCTTTCGAGAAACCCG	Endo
GCTTTCGAGCAGGGAG	ExciteL5
GCTTTCGAGCCTCAAT	Astrocytes
GCTTTCGAGGTCACCC	Pericytes
GCTTTCGAGGTCGCCT	ExciteL6
GCTTTCGAGTGTTGAA	ExciteL6
GCTTTCGCAACTCCCT	ExciteL6
GCTTTCGCACGGTCTG	OPCs
GCTTTCGCATTGCCGG	Microglia
GCTTTCGGTGTATACC	ExciteL6
GCTTTCGTCACACCGG	MOLs
GCTTTCGTCTCTAGGA	Astrocytes
GGAACCCAGGCGCTTC	InhibNeuron
GGAACCCAGGTTGACG	Microglia
GGAACCCCAAGCCTGC	ExciteL5
GGAACCCGTAGGAGTC	ExciteL5
GGAACCCGTCGCTTGG	Astrocytes
GGAACCCGTGGCACTC	ExciteNP
GGAACCCGTTCTTGCC	ExciteL4
GGAACCCTCCTTGGAA	ExciteL4
GGAAGTGAGCCAACCC	COPs
GGAAGTGAGGAGCAAA	ExciteL6
GGAAGTGAGTCTCTGA	MOLs
GGAAGTGCAATTCTCT	Microglia
GGAAGTGCACTCGATA	ExciteL4
GGAAGTGCAGCTCTGG	ExciteNP
GGAAGTGGTAGCGTCC	NIPCs
GGAATCTAGCTCCGAC	OPCs
GGAATCTAGTTTCAGC	Pericytes
GGAATCTGTATCATGC	OPCs
GGAATCTTCCGTGTCT	ExciteL4
GGAATGGAGCACTCTA	Astrocytes
GGAATGGAGGATGAGA	OPCs
GGAATGGAGGCAGCTA	MOLs
GGAATGGAGTCAGCCC	ExciteL6
GGAATGGCACAGTATC	OPCs
GGAATGGCATATAGCC	ExciteL4
GGAATGGGTTAACCTG	ExciteL6
GGAATGGGTTATAGAG	COPs
GGACGTCAGGAGAATG	InhibNeuron
GGACGTCCAAACACCT	Astrocytes
GGACGTCGTTGGAGGT	ExciteL23
GGACGTCTCATAGAGA	ExciteL4
GGACGTCTCCGATAAC	Astrocytes
GGACGTCTCGCTGTCT	ExciteL6
GGAGAACAGACGGTCA	COPs
GGAGAACAGGAGAATG	Microglia
GGAGAACAGTGGTTAA	ExciteL4
GGAGAACCAACAGCCC	Microglia
GGAGAACCAAGGATGC	ExciteNP
GGAGAACGTATGCAAA	MOLs
GGAGAACGTCTGATAC	ExciteL4
GGAGAACTCGCCACTT	ExciteL6
GGAGATGAGCACCTGC	ExciteL6
GGAGATGCAGCCTATA	MOLs
GGAGATGCAGGTGACA	OPCs
GGAGATGGTCTGATAC	ExciteL4
GGAGATGTCCAGCTCT	Astrocytes
GGAGATGTCTTAGCCC	ExciteL6
GGAGATGTCTTGTGCC	InhibNeuron
GGAGCAAAGCCGTCGT	OPCs
GGAGCAAAGCGAGTCA	Microglia
GGAGCAAAGGTAAACT	ExciteL6
GGAGCAACAAGCTGCC	ExciteL4
GGAGCAACATGATAGA	OPCs
GGAGCAAGTAACCAGG	ExciteNP
GGAGCAATCAGCTTGA	Microglia
GGAGGATAGGTATTGA	OPCs
GGAGGATCATGTGCTA	MOLs
GGAGGATGTCAAACGG	ExciteL23
GGAGGTAAGACGTCCC	ExciteL4
GGAGGTAAGATCCCAT	ExciteL6
GGAGGTAAGTATCCTG	ExciteL6
GGAGGTAAGTTGTACC	OPCs
GGAGGTACACAACCGC	MOLs
GGAGGTACATGGGCAA	ExciteL4
GGAGGTAGTGAGCAGT	Microglia
GGAGGTATCAAAGGAT	ExciteL4
GGAGGTATCCCGTGAG	MOLs
GGATCTACAAGCGAGT	Microglia
GGATCTACACCGCTGA	ExciteL6
GGATCTAGTAACAAGT	ExciteL6
GGATCTAGTCGTGATT	ExciteL6
GGATCTATCTCAGGCG	Microglia
GGATCTATCTGTGTGA	MOLs
GGATGTTAGCTCACTA	MOLs
GGATGTTCAAATCCCA	ExciteL23
GGATGTTCACTACCCT	OPCs
GGATGTTGTAGACACG	OPCs
GGATGTTGTCAACATC	Astrocytes
GGATGTTGTCCAAAGG	ExciteL4
GGATGTTGTTGGGAAC	Astrocytes
GGATGTTGTTGTCTAG	ExciteL6
GGATGTTTCCTGTTAT	Astrocytes
GGATGTTTCTAAGGAA	Endo
GGATGTTTCTACCCAC	ExciteL6
GGCACGTAGCAGCCCT	NIPCs
GGCACGTAGCCGAATG	Microglia
GGCACGTAGGGTTGCA	Astrocytes
GGCACGTAGTCGAAGC	MOLs
GGCAGTCAGACAACAT	Astrocytes
GGCAGTCAGCTCGCAC	ExciteL4
GGCAGTCAGTTATGGA	Astrocytes
GGCAGTCCAAGCCATT	MOLs
GGCAGTCGTAGACGGT	ExciteL23
GGCAGTCGTGAGTCAG	MOLs
GGCAGTCTCGAGAGCA	MOLs
GGCAGTCTCGTGCAGC	Microglia
GGCAGTCTCTATACGG	MOLs
GGCGTCAAGTTGCATC	Astrocytes
GGCGTCACAAGAGTTA	Astrocytes
GGCGTCACAATTGCTG	Macrophages
GGCGTCACATATGAAG	InhibNeuron
GGCGTCAGTCTGCAAT	MOLs
GGCGTCATCGTCCATC	ExciteL6
GGCTGTGAGACTACGG	ExciteL4
GGCTGTGCACTTGGCG	Microglia
GGCTGTGGTAGTCACT	MOLs
GGCTGTGGTTAAGCAA	Astrocytes
GGCTGTGTCAGGAAGC	Microglia
GGCTTGGAGGGACACT	ExciteL5
GGCTTGGAGTACAACA	ExciteL6
GGCTTGGCAAATCCCA	MOLs
GGCTTGGCAGGAATCG	ExciteL23
GGCTTGGGTAGTGTGG	OPCs
GGCTTGGGTCGACTTA	Microglia
GGCTTGGGTCTAGGCC	ExciteNP
GGCTTGGTCATCCTAT	MOLs
GGCTTGGTCTGCATAG	Microglia
GGCTTTCAGGGAGGAC	Microglia
GGCTTTCGTATCAAGA	ExciteL4
GGCTTTCTCCAACCAA	Microglia
GGGAAGTAGACGGTTG	ExciteL4
GGGAAGTAGCGACAGT	Astrocytes
GGGAAGTAGCGGATCA	NIPCs
GGGAAGTCACCAATTG	MOLs
GGGAAGTCAGAAATCA	ExciteL6
GGGAAGTGTCGCTTGG	MOLs
GGGAAGTGTTCGGCGT	Microglia
GGGAAGTGTTGTAGCT	ExciteL6
GGGAAGTTCCAGCCTT	MOLs
GGGAAGTTCGCTGTCT	Astrocytes
GGGACAAAGACTCTTG	Microglia
GGGACAAAGATTGATG	ExciteNP
GGGACAAAGTTGTAAG	Microglia
GGGACAACATCCGTGG	OPCs
GGGACAACATTGTCGA	Microglia
GGGACAAGTCGACGCT	Astrocytes
GGGACAATCCTCTGCA	ExciteL23
GGGACAATCTTACTGT	ExciteL4
GGGACCTAGGAAGAAC	MOLs
GGGACCTAGGCAGGTT	ExciteL6
GGGACCTAGGGAGGTG	Microglia
GGGACCTCAACAGATA	ExciteNP
GGGACCTCACTCTAGA	MOLs
GGGACCTTCCAAATGC	ExciteL4
GGGACCTTCTATCGCC	MOLs
GGGACTCAGGTTCACT	MOLs
GGGACTCAGTCAGAGC	MOLs
GGGACTCCACAATGCT	Astrocytes
GGGACTCCAGGTCCCA	ExciteL6
GGGACTCGTAACAAGT	Microglia
GGGACTCGTGCCTACG	ExciteL5
GGGACTCTCTATACTC	ExciteL4
GGGAGATAGAGTTGCG	Microglia
GGGAGATAGTGCGTCC	Microglia
GGGAGATCACCCTCTA	MOLs
GGGAGATCAGGCTATT	COPs
GGGAGATCAGTAACAA	ExciteL4
GGGAGATGTACGGCAA	Astrocytes
GGGAGATGTTATCTGG	ExciteL23
GGGAGATGTTCGTGCG	NIPCs
GGGAGATGTTGTGTAC	ExciteL6
GGGAGATTCCGAACGC	ExciteL6
GGGAGATTCCGTTTCG	ExciteL4
GGGAGATTCGGACCAC	Microglia
GGGAGTAAGGTTCAGG	COPs
GGGAGTAAGTTGGCTT	MOLs
GGGAGTACAAACTCGT	MOLs
GGGAGTACAACAGAGC	ExciteL6
GGGAGTACACCTATCC	Microglia
GGGAGTAGTCTGCAAT	OPCs
GGGAGTAGTCTGCCTT	ExciteL23
GGGAGTAGTTGAGAGC	Microglia
GGGAGTATCACTTGGA	Astrocytes
GGGATCCCACTCCCTA	ExciteL4
GGGATCCCAGTTGTTG	OPCs
GGGATCCGTTTGTTCT	MOLs
GGGATCCTCCCTCGAT	InhibNeuron
GGGATCCTCGTTCAGA	Astrocytes
GGGATCCTCTGCGATA	Microglia
GGGATGAAGATTCGAA	ExciteL4
GGGATGAGTTAAAGTG	ExciteL4
GGGATGAGTTCGGCTG	ExciteL6
GGGATGATCGTTCCCA	Microglia
GGGCCATAGAATCGTA	Microglia
GGGCCATAGATACTGA	MOLs
GGGCCATCACTTGGCG	Astrocytes
GGGCCATCAGAAATCA	OPCs
GGGCCATCATCCGCGA	InhibNeuron
GGGCCATGTGATCGTT	ExciteL4
GGGCCATGTGTGGACA	Astrocytes
GGGCCATTCGGAGTAG	Microglia
GGGCGTTAGGGAACAA	InhibNeuron
GGGCGTTCAAGACCTT	ExciteNP
GGGCGTTCAAGCCTGC	ExciteL6
GGGCGTTGTGCCGGTT	MOLs
GGGCGTTGTTAATGAG	Microglia
GGGCGTTGTTGGGTTT	MOLs
GGGCGTTGTTGTCAGT	ExciteL4
GGGCGTTTCATGCGGC	ExciteL5
GGGCGTTTCCTAAGTG	COPs
GGGCGTTTCGAAGGAC	Astrocytes
GGGCTACAGAGTTGAT	Astrocytes
GGGCTACAGGTCGACA	ExciteL23
GGGCTACAGTAACCTC	Astrocytes
GGGCTACAGTTACTCG	Microglia
GGGCTACAGTTCTCTT	Macrophages
GGGCTACCAAGCGAGT	ExciteL4
GGGCTACCACCAAATC	Microglia
GGGCTACCACCTCAGG	Endo
GGGCTACTCGAAGTGG	ExciteL4
GGGCTACTCGACCACG	ExciteL6
GGGCTCAAGCAGAAAG	MOLs
GGGCTCAAGCATCAAA	MOLs
GGGCTCACAGGAGGAG	MOLs
GGGCTCACATGACTGT	Endo
GGGCTCAGTCACCCTT	MOLs
GGGCTCAGTCTCGCGA	Astrocytes
GGGCTCATCCTACGGG	NIPCs
GGGTAGAAGCCATTTG	Astrocytes
GGGTAGACACACCAGC	MOLs
GGGTAGACAGCATCTA	Microglia
GGGTAGACATAATGCC	OPCs
GGGTAGACATATGCGT	Microglia
GGGTAGAGTGACTCGC	InhibNeuron
GGGTAGAGTGCACGCT	InhibNeuron
GGGTAGAGTTTCTTAC	Microglia
GGGTAGATCCACGGAC	OPCs
GGGTAGATCTCACCCA	Astrocytes
GGGTATTAGAATTTGG	Astrocytes
GGGTATTAGACTCAAA	Pericytes
GGGTATTAGTGGATTA	ExciteNP
GGGTATTAGTTTCTTC	MOLs
GGGTATTCAAGAAATC	Microglia
GGGTATTCAATTGGTC	ExciteL5
GGGTATTGTAGCGAGT	ExciteNP
GGGTATTTCCATTCAT	Pericytes
GGGTATTTCCGCCTAT	Microglia
GGGTATTTCCTGGTCT	OPCs
GGGTCACAGGACTAAT	ExciteL4
GGGTCACCACTACGGC	Microglia
GGGTCACGTCCAAATC	ExciteL6
GGGTCACGTGGATTTC	ExciteL4
GGGTCACGTGTCCAAT	Microglia
GGGTCACGTTTCGTGA	ExciteL23
GGGTCACTCACCTTGC	ExciteL23
GGGTCACTCATCTACT	ExciteL4
GGGTCTGCAACTCGAT	InhibNeuron
GGGTCTGCAAGCGAAC	ExciteL23
GGGTCTGCAGCAGGAT	ExciteL6
GGGTCTGCAGCCGTTG	MOLs
GGGTCTGCAGCGCGTT	OPCs
GGGTCTGTCACTCCGT	InhibNeuron
GGGTCTGTCTGAATGC	MOLs
GGGTGAAAGACGATAT	ExciteL4
GGGTGAAAGGAAGAAC	ExciteL23
GGGTGAAGTAGGCAAC	ExciteL4
GGGTGAAGTTAACCTG	MOLs
GGGTGAAGTTAAGCAA	ExciteL6
GGGTGTCAGCGCGTTC	COPs
GGGTGTCAGGCTTAGG	MOLs
GGGTGTCCAAATGATG	COPs
GGGTGTCCACCTGAAT	ExciteL6
GGGTGTCCATCCGTGG	ExciteL4
GGGTGTCGTATTCCTT	MOLs
GGGTGTCGTCCAGCGT	InhCajalRetzius
GGGTGTCGTTGTCTAG	Microglia
GGGTGTCTCCCAACTC	Microglia
GGGTGTCTCCGGCTTT	MOLs
GGGTGTCTCGAGCACC	Microglia
GGGTGTCTCGTTCTCG	ExciteL4
GGGTGTCTCTCGTTTA	Astrocytes
GGGTTATAGTTGAATG	MOLs
GGGTTATCAAGGTCAG	Microglia
GGGTTATCATTCATCT	ExciteL5
GGGTTATGTAGCGTTT	MOLs
GGGTTATGTCAAGCCC	ExciteNP
GGGTTATTCACAGAGG	MOLs
GGGTTATTCACAGTGT	MOLs
GGGTTATTCTCGTCGT	Astrocytes
GGGTTTAAGAATTGTG	Microglia
GGGTTTAAGATAACGT	Astrocytes
GGGTTTAAGGTTCCGC	Microglia
GGGTTTACAAATTGCC	ExciteL6
GGGTTTACAATCAGCT	MOLs
GGGTTTATCATTGCTT	MOLs
GGGTTTATCGACGACC	MOLs
GGTAACTAGCTATCTG	Microglia
GGTAACTAGGTATCTC	NIPCs
GGTAACTCATAGACTC	Microglia
GGTAACTGTAGCGTCC	MOLs
GGTAACTGTGCAATAA	MOLs
GGTAACTGTGTCCGGT	ExciteL4
GGTAACTTCCGTCACT	ExciteL6
GGTAACTTCGCGCCAA	MOLs
GGTAACTTCTGACCCT	COPs
GGTAATCCACATAACC	MOLs
GGTAATCCACCTATCC	ExciteL6
GGTAATCTCGAGAGCA	ExciteL6
GGTAGAGAGAACCGCA	Astrocytes
GGTAGAGAGCGGGTAT	ExciteNP
GGTAGAGCAAACTCTG	Endo
GGTAGAGGTCGATTAC	ExciteL4
GGTAGAGTCTTCCCGA	ExciteL4
GGTCACGAGCATTTCG	ExciteL4
GGTCACGAGTATAGAC	NIPCs
GGTCACGAGTTCTCTT	MOLs
GGTCACGGTCCGCAGT	Astrocytes
GGTCACGTCATGAGTC	OPCs
GGTCACGTCTCTTAAC	ExciteL6
GGTCACGTCTTTCCGG	ExciteL4
GGTCTGGAGACCGCCT	MOLs
GGTCTGGGTCCCAAAT	ExciteL4
GGTCTGGGTCGAACGA	Astrocytes
GGTCTGGGTGCATCTA	OPCs
GGTCTGGTCAAGTGGG	ExciteL23
GGTCTGGTCAGTCAGT	ExciteL23
GGTGAAGAGGGTTAGC	OPCs
GGTGAAGGTGACGTCC	Astrocytes
GGTGAAGGTGCTATTG	ExciteL23
GGTGATTAGGTAAAGG	ExciteL23
GGTGATTCAACTCCCT	ExciteL4
GGTGATTGTAGTGATA	OPCs
GGTGATTGTATTTCTC	ExciteL4
GGTGATTGTGAGTTGG	ExciteL4
GGTGATTGTTGTGTAC	COPs
GGTGATTTCAAGCCTA	MOLs
GGTGATTTCCCAGCGA	ExciteL23
GGTGGCTCAGCAAGAC	ExciteL6
GGTGGCTGTAACGATA	ExciteL6
GGTGGCTGTGACAGCA	InhibNeuron
GGTGGCTTCACGGACC	Microglia
GGTGGCTTCGGATAAA	Microglia
GGTGTCGAGTGGGAAA	Astrocytes
GGTGTCGGTCGACGCT	ExciteL6
GGTGTCGGTCGGCCTA	ExciteL4
GGTGTCGGTTCTGACA	Microglia
GGTGTTAAGGTGCATG	Microglia
GGTGTTACACGGGCTT	ExciteL4
GGTGTTAGTCCTTAAG	ExciteL23
GGTGTTAGTGTTCAGT	ExciteL6
GGTTAACAGGGCTGAT	ExciteL4
GGTTAACCAACCACAT	ExciteL4
GGTTAACCAAGGTCTT	Microglia
GGTTAACCAGTCAGCC	MOLs
GGTTAACCATAGAATG	InhibNeuron
GGTTAACTCCCGTGTT	COPs
GGTTCTCAGCATTGTC	MOLs
GGTTCTCAGCCAAGTG	Endo
GGTTCTCCATGACGGA	ExciteL6
GGTTCTCTCCTTTGAT	Microglia
GGTTCTCTCGACTCCT	ExciteL6
GGTTCTCTCGATTGAC	Microglia
GGTTGTAAGCAGCCCT	ExciteL5
GGTTGTAAGGACTTCT	ExciteL5
GGTTGTAAGGCGAAGG	ExciteL6
GGTTGTACAACGTTAC	ExciteL6
GGTTGTATCACACCGG	Pericytes
GGTTGTATCGCAACAT	OPCs
GTAACACAGATGAACT	Macrophages
GTAACACCAATCCTAG	ExciteL4
GTAACACGTATAGGGC	ExciteL4
GTAACACTCTGTGCGG	Astrocytes
GTAACCAAGCAGCAGT	OPCs
GTAACCAGTACCCGAC	MOLs
GTAACCAGTACGAAAT	Astrocytes
GTAACCAGTAGTCGGA	Microglia
GTAACCAGTTAGGGAC	Astrocytes
GTAACCATCAAGCCCG	ExciteL6
GTAACCATCACCGGGT	OPCs
GTAACCATCACCTACC	MOLs
GTAACCATCGAGAAAT	OPCs
GTAACCATCTCCAATT	InhibNeuron
GTAAGTCAGTTCCATG	ExciteL4
GTAAGTCCAGCTGAAG	ExciteL4
GTAAGTCCATTCCTCG	Microglia
GTAAGTCGTAGCGTCC	Microglia
GTAAGTCGTAGGTACG	ExciteL5
GTAAGTCGTCCTCCTA	MOLs
GTAAGTCGTGCCGTTG	MOLs
GTAAGTCTCAGATGCT	ExciteL4
GTAAGTCTCTTCCACG	MOLs
GTAATCGCACTGGACC	MOLs
GTAATCGCACTGTCCT	MOLs
GTAATCGCACTGTCGG	ExciteL6
GTAATCGCAGCAGACA	ExciteNP
GTAATCGGTACAGAAT	Astrocytes
GTAATCGGTACGAGCA	MOLs
GTAATGCAGTCGCCCA	NIPCs
GTAATGCCAAGTTCGT	Endo
GTAATGCCAGAACATA	Microglia
GTAATGCGTACTTCCC	ExciteL4
GTAATGCGTATCGATC	Microglia
GTAATGCGTCTACTGA	COPs
GTAATGCGTTGCCATA	Microglia
GTAATGCGTTGGACCC	OPCs
GTAATGCTCAAGCTTG	ExciteL4
GTAATGCTCACACCGG	ExciteL6
GTAATGCTCCATACTT	MOLs
GTAATGCTCGATGCTA	ExciteL4
GTAATGCTCGTCACCT	ExciteL4
GTAATGCTCTCGAGTA	Microglia
GTACAACAGCGGTAGT	Microglia
GTACAACAGTTGCTGT	Microglia
GTACAACCAACGGCTC	Microglia
GTACAACCAACTCGTA	ExciteL4
GTACAACCACCGGAAA	ExciteL4
GTACAACCAGAACGCA	ExciteL6
GTACAACGTCCTCCTA	ExciteL6
GTACAACTCTCCGTGT	ExciteL4
GTACAGTAGAAGGTAG	ExciteL6
GTACAGTAGCGATTCT	ExciteL4
GTACAGTAGCTTCTAG	ExciteL23
GTACAGTAGTCAGCGA	MOLs
GTACAGTAGTTCATGC	MOLs
GTACAGTGTACCGGCT	Microglia
GTACAGTGTCGATGCC	Microglia
GTACAGTTCTTACCAT	ExciteL6
GTAGAAAAGATGCTAA	ExciteL4
GTAGAAAAGCATGCGA	Microglia
GTAGAAAAGGTAGGCT	OPCs
GTAGAAAAGGTTGGTG	Microglia
GTAGAAACAACACAAA	Astrocytes
GTAGAAACACAGTATC	Microglia
GTAGAAACATCATCCC	Astrocytes
GTAGAAAGTGTCATGT	Astrocytes
GTAGAGGAGCGCACAA	Endo
GTAGAGGCAATGGGTG	OPCs
GTAGAGGCATGGAGAC	Microglia
GTAGAGGTCCCGTTGT	ExciteL4
GTAGAGGTCGATACAC	MOLs
GTAGAGGTCGGTAACT	Astrocytes
GTAGAGGTCTCATTGT	ExciteNP
GTAGATCAGACCTCCG	ExciteL6
GTAGATCAGAGTGGCT	COPs
GTAGATCAGTCGTCTA	OPCs
GTAGATCAGTTCCGGC	MOLs
GTAGATCCAGTAGAAT	MOLs
GTAGATCCATAGACTC	Microglia
GTAGATCGTAAGATCA	MOLs
GTAGATCGTAGGTAGC	ExciteL4
GTAGATCGTCAACCAT	ExciteL6
GTAGATCGTGCTCTTC	ExciteL4
GTAGATCTCCGACGGT	MOLs
GTAGATCTCGGAGTAG	ExciteL4
GTAGCTAAGGCCCACT	ExciteL4
GTAGCTACAGCGTATT	MOLs
GTAGCTACATTCTTCA	ExciteL5
GTAGCTAGTCCTTTGC	Astrocytes
GTAGCTAGTCGTACAT	MOLs
GTAGCTAGTGCAGATG	COPs
GTAGCTAGTGTATTCG	ExciteNP
GTAGCTATCAAGGACG	Endo
GTAGGAGAGCACACCC	Microglia
GTAGGAGAGCCGATAG	ExciteL4
GTAGGAGAGGCTGTAG	MOLs
GTAGGAGAGGTCGTAG	ExciteL5
GTAGGAGCAAGATGTA	ExciteL4
GTAGGAGCACAAACGG	Microglia
GTAGGAGCACTTCAAG	Microglia
GTAGGAGCAGCCATTA	Microglia
GTAGGAGCATGTCGTA	ExciteL4
GTAGGAGTCCGACATA	Microglia
GTAGGAGTCTCCCATG	ExciteL6
GTAGGAGTCTTCTGTA	ExciteL6
GTAGGTTAGCGATGAC	MOLs
GTAGGTTCACTGGAAG	Microglia
GTAGGTTCAGGACGAT	ExciteL6
GTAGGTTCATGACAAA	Microglia
GTAGGTTGTCCCGCAA	Endo
GTAGGTTGTTATGTGC	OPCs
GTAGGTTGTTTAAGGA	OPCs
GTAGGTTTCATCGCCT	ExciteL4
GTAGGTTTCTCCAATT	ExciteL4
GTAGGTTTCTGGGCAC	ExciteL6
GTAGTACAGACAACAT	Microglia
GTAGTACAGGTACTGG	ExciteL4
GTAGTACCACTCCGGA	ExciteNP
GTAGTACCAGTTGCGC	OPCs
GTAGTACTCGACCAAT	ExciteL5
GTAGTACTCTCATAGG	COPs
GTATTGGAGATCCCAT	MOLs
GTATTGGAGGCACTAG	ExciteL6
GTATTGGTCCTCTAAT	InhibNeuron
GTATTGGTCGAGTACT	ExciteL4
GTATTTCAGTTAGTGA	Astrocytes
GTATTTCCACGGCCAT	MOLs
GTCAAACCAGCGGTTC	OPCs
GTCAAACGTATTGGCT	ExciteL6
GTCAAACGTCACCGCA	ExciteL4
GTCAAACGTGCATACT	MOLs
GTCAAACGTGTTACAC	Microglia
GTCAAACTCAGATTGC	COPs
GTCAAACTCGGCCCAA	Microglia
GTCAAACTCTGCCCTA	Microglia
GTCAAGTAGCGACTTT	ExciteL4
GTCAAGTAGGCGACAT	MOLs
GTCAAGTAGGGCTGAT	Astrocytes
GTCAAGTCACGAGGTA	OPCs
GTCAAGTCACTTGAGT	OPCs
GTCAAGTCAGTCACGC	ExciteL4
GTCAAGTCAGTGGTGA	NIPCs
GTCAAGTGTCAATGGG	InhibNeuron
GTCAAGTTCAATGCAC	ExciteL23
GTCAAGTTCGTTGTTT	Microglia
GTCACGGAGATGGTCG	ExciteL6
GTCACGGAGGAGGCAG	Microglia
GTCACGGAGGTGCAGT	Microglia
GTCACGGAGTAATTGG	MOLs
GTCACGGAGTATGGAT	Microglia
GTCACGGGTACTCGCG	ExciteL6
GTCACGGGTCGTCGGT	COPs
GTCACGGGTGTCTAAC	MOLs
GTCACGGGTTAATGAG	Microglia
GTCACGGTCCGTCACT	NIPCs
GTCACTCAGAAGCTGC	Microglia
GTCACTCAGGTTCTAC	MOLs
GTCACTCAGTAAAGCT	ExciteL6
GTCACTCAGTCGAGGT	Microglia
GTCACTCAGTTGAAAC	Microglia
GTCACTCCAACTCGTA	InhibNeuron
GTCACTCCAAGGATGC	COPs
GTCACTCCAATGTCTG	ExciteL4
GTCACTCTCAGACAAA	Microglia
GTCACTCTCTAAGAAG	Microglia
GTCACTCTCTTGGCTC	OPCs
GTCAGCGAGCGACTGA	ExciteL6
GTCAGCGAGTAGGATT	MOLs
GTCAGCGAGTATGAAC	MOLs
GTCAGCGCAAGACGAC	Microglia
GTCAGCGCATGACTCA	Microglia
GTCAGCGGTTGTTTGG	ExciteL23
GTCATCCAGAAGGGAT	Astrocytes
GTCATCCCAATCAGCT	ExciteL23
GTCATCCGTACGTGTT	ExciteL6
GTCATCCGTGAGCTCC	MOLs
GTCATCCGTTGAATCC	ExciteL4
GTCATCCTCCTATGGA	MOLs
GTCATGACACACTGGC	OPCs
GTCATGACAGCGACAA	OPCs
GTCATGACATGACAAA	Microglia
GTCATGAGTACGGGAT	ExciteL5
GTCATGAGTAGCTCGC	ExciteL23
GTCATGAGTGCAGATG	MOLs
GTCATGAGTGGATCGA	NIPCs
GTCATGAGTGGTTTGT	MOLs
GTCATTTAGATGACAT	ExciteL4
GTCATTTAGCCTAACT	Microglia
GTCATTTAGTACAGCG	InhibNeuron
GTCATTTGTGTTCATG	ExciteL5
GTCATTTTCACGAGGA	OPCs
GTCATTTTCTCATTAC	Endo
GTCCACTAGAGTATAC	Microglia
GTCCACTCACTACCCT	MOLs
GTCCACTGTCGTACAT	InhibNeuron
GTCCACTTCGCCATAA	Microglia
GTCCACTTCGGCTGGT	Microglia
GTCCACTTCTCCGATC	MOLs
GTCCCATAGCATGTTC	ExciteL23
GTCCCATAGTGTTGTC	Endo
GTCCCATGTATACCCA	Astrocytes
GTCCCATGTGCCTGCA	ExciteL5
GTCCCATTCGTAGCCG	OPCs
GTCCCATTCTGCTCTG	Microglia
GTCCTCAAGCTCTGTA	COPs
GTCCTCAAGTCTGCGC	ExciteNP
GTCCTCACATCGATCA	MOLs
GTCCTCAGTGGCACTC	ExciteL4
GTCCTCAGTTAGAGAT	Astrocytes
GTCCTCATCCAGTTCC	ExciteL23
GTCCTCATCGTTCTCG	ExciteL4
GTCCTCATCTGGGCAC	Microglia
GTCGAATAGATACTGA	Microglia
GTCGAATAGCGGGTAT	NIPCs
GTCGAATAGCTATCCA	MOLs
GTCGAATAGTTGCTCA	Microglia
GTCGAATCAAGTGGGT	MOLs
GTCGAATGTAGAGCTG	Microglia
GTCGAATGTCACTCAA	Astrocytes
GTCGAATGTTACCCTC	MOLs
GTCGAATTCCACTGGG	OPCs
GTCGAATTCTTGGGCG	Astrocytes
GTCGCGAAGCACCAGA	Astrocytes
GTCGCGAAGTCATGGG	ExciteL4
GTCGCGACAACCAGAG	ExciteL23
GTCGCGACAGCTGTGC	Microglia
GTCGCGACATCGTTCC	Microglia
GTCGCGAGTCTAACGT	ExciteL4
GTCGCGAGTCTACTGA	Microglia
GTCGCGAGTTCATCGA	Astrocytes
GTCGCGATCCTGCCAT	InhibNeuron
GTCGCGATCGTACCTC	ExciteL4
GTCGTAAAGCAAATCA	Pericytes
GTCGTAAAGCTCGTGC	Microglia
GTCGTAAAGGCCTTGC	MOLs
GTCGTAAAGTGCTACT	InhibNeuron
GTCGTAAAGTGGTTGG	OPCs
GTCGTAACAATGAGCG	ExciteL4
GTCGTAACATGACAAA	ExciteL6
GTCGTAAGTAGAGATT	ExciteL23
GTCGTAAGTATACGGG	Microglia
GTCGTAAGTATCGATC	ExciteL6
GTCGTAATCGCGGTAC	ExciteL23
GTCGTAATCTAGATCG	ExciteL23
GTCGTAATCTCCGAGG	ExciteL6
GTCGTTCAGAAACTGT	MOLs
GTCGTTCAGACCAAGC	OPCs
GTCGTTCAGGAAAGGT	MOLs
GTCGTTCAGTGTTCCA	OPCs
GTCGTTCCAACCAACT	Astrocytes
GTCGTTCCACACCGAC	ExciteL4
GTCGTTCCAGATCCAT	ExciteL4
GTCGTTCGTAGGTCAG	InhibNeuron
GTCGTTCGTATTTCCT	Astrocytes
GTCGTTCGTCATGGCC	ExciteL5
GTCGTTCTCAGACCGC	ExciteNP
GTCTACCAGTGGTTCT	ExciteL6
GTCTACCCACATATCG	Microglia
GTCTACCCACGCTTAA	MOLs
GTCTACCGTCTTGAGT	OPCs
GTCTACCTCATGCATG	Astrocytes
GTCTACCTCCACGAAT	ExciteL4
GTCTACCTCGGCGATC	OPCs
GTCTAGAAGCGCCCAT	MOLs
GTCTAGACACAAATCC	Microglia
GTCTAGACACATCATG	NIPCs
GTCTAGAGTCGCCTAG	OPCs
GTCTAGAGTGGCAACA	ExciteL4
GTCTAGATCCTGGTCT	ExciteL6
GTCTCACAGCACTCAT	Microglia
GTCTCACAGCTTCATG	ExciteL4
GTCTCACAGTAAGCAT	ExciteL23
GTCTCACTCGTCGCTT	MOLs
GTCTGTCAGGCCATAG	InhibNeuron
GTCTGTCAGGGCTTCC	ExciteL5
GTCTGTCAGGTAGTCG	InhibNeuron
GTCTGTCAGTAGGATT	Microglia
GTCTGTCCACAATGAA	Microglia
GTCTGTCCAGCCGGTT	MOLs
GTCTGTCTCCCATTCG	Microglia
GTCTGTCTCGAACGCC	Microglia
GTCTGTCTCTACACTT	OPCs
GTCTGTCTCTCAACGA	ExciteL4
GTCTTTACAACCGATT	Microglia
GTCTTTACACGACGCT	Microglia
GTCTTTAGTGAGATCG	Astrocytes
GTCTTTAGTTCTAACG	Astrocytes
GTCTTTATCTAACACG	Microglia
GTCTTTATCTGTGCGG	COPs
GTGACGCAGAAATTGC	Microglia
GTGACGCAGAGGCCAT	MOLs
GTGACGCAGGACAACC	ExciteL4
GTGACGCAGTCCTGCG	Microglia
GTGACGCCACTCCGGA	MOLs
GTGACGCCAGAGGGTT	Microglia
GTGACGCCAGAGTTCT	ExciteL6
GTGACGCCAGTAACGG	ExciteNP
GTGACGCCAGTATGAA	Microglia
GTGACGCCATAATGAG	OPCs
GTGACGCGTACGACTT	Fibroblasts
GTGACGCGTCTCGGGT	ExciteL6
GTGACGCGTTGTATGC	Astrocytes
GTGACGCTCATGCCCT	Microglia
GTGACGCTCGTCCATC	ExciteNP
GTGAGCCAGCCACCGT	Astrocytes
GTGAGCCAGGTTTGAA	ExciteL4
GTGAGCCCAAGTAGTA	InhibNeuron
GTGAGCCCAATACGCT	Astrocytes
GTGAGCCCACCATTCC	NIPCs
GTGAGCCCACCGCTGA	NIPCs
GTGAGCCGTCGGAACA	COPs
GTGAGCCGTTCTCCAC	ExciteL4
GTGAGCCGTTGGGAAC	ExciteL6
GTGAGCCTCCTATTGT	MOLs
GTGAGCCTCTGCTTAT	Endo
GTGAGGAAGCTGCCTG	ExciteL4
GTGAGGAAGGATTCAA	Microglia
GTGAGGAAGGCCGCTT	Microglia
GTGAGGAGTAGCACGA	ExciteL4
GTGAGGAGTAGTCTGT	Astrocytes
GTGAGGAGTGACCGTC	ExciteL23
GTGAGGAGTTAGGCCC	Pericytes
GTGAGGATCGCTTGCT	Endo
GTGAGGATCTTGGAAC	OPCs
GTGAGTTAGGGTCTTT	Astrocytes
GTGAGTTCACGCTGCA	InhibNeuron
GTGAGTTCATATCTCT	OPCs
GTGAGTTGTGACAACG	NIPCs
GTGAGTTTCAAGGACG	MOLs
GTGAGTTTCAAGGAGC	ExciteL4
GTGAGTTTCCGCATAA	ExciteL6
GTGAGTTTCCTCTCGA	ExciteNP
GTGAGTTTCTGCTTAT	ExciteL4
GTGATGTAGGCGACAT	NIPCs
GTGATGTAGGGAGGAC	Astrocytes
GTGATGTAGTTAGTGA	ExciteL4
GTGATGTCAAATAAGC	Astrocytes
GTGATGTCACTTGGCG	ExciteL6
GTGATGTCAGGCCTGT	OPCs
GTGATGTCATCAGTGT	Microglia
GTGATGTGTAAGGCCA	MOLs
GTGATGTGTACCGGAA	ExciteL4
GTGATGTGTCAGGTAG	MOLs
GTGATGTGTGACTGTT	Astrocytes
GTGATGTGTGTGCCTG	Astrocytes
GTGATGTTCCGGGACT	OPCs
GTGCACGAGGTGATAT	ExciteL23
GTGCACGAGTACCCTA	Microglia
GTGCACGCAACCGATT	MOLs
GTGCACGCAGAACGCA	ExciteL4
GTGCACGGTTTACTTC	ExciteL4
GTGCACGGTTTCGGCG	Microglia
GTGCAGCAGGGCAATC	OPCs
GTGCAGCAGTCTCTGA	Astrocytes
GTGCAGCCAAATTGGA	Endo
GTGCAGCCACTTTATC	ExciteL23
GTGCAGCCATAAGATG	Microglia
GTGCAGCTCGAGAAAT	Microglia
GTGCAGCTCGATAACC	ExciteL6
GTGCAGCTCTTCTGGC	MOLs
GTGCGTGGTGCCTAAT	Astrocytes
GTGCGTGTCACGTCCT	ExciteL6
GTGCGTGTCGGTGAAG	ExciteL6
GTGCTGGAGGGCCAAT	Astrocytes
GTGCTGGAGGTCGCCT	ExciteL23
GTGCTGGGTCTGCGCA	ExciteL6
GTGCTGGTCACTCCGT	Microglia
GTGCTGGTCCAGTGCG	ExciteL6
GTGCTGGTCTTTCAGT	Microglia
GTGCTTCAGTCTACCA	Microglia
GTGCTTCCATGTCAGT	Pericytes
GTGCTTCGTACCCGAC	Astrocytes
GTGCTTCGTCCAGCAC	Pericytes
GTGCTTCGTCGCTTAA	Microglia
GTGCTTCGTTATAGAG	InhibNeuron
GTGCTTCTCAATCCAG	ExciteL6
GTGCTTCTCAGGTGTT	COPs
GTGCTTCTCATTACGG	Pericytes
GTGGAAGAGGTCTACT	Microglia
GTGGAAGAGGTCTGGA	ExciteL6
GTGGAAGAGTTCGGTT	MOLs
GTGGAAGGTATCTTCT	Astrocytes
GTGGAAGGTTAAGGAT	Microglia
GTGGAAGGTTGCGTAT	MOLs
GTGGAAGTCCTTATGT	Microglia
GTGGAAGTCTTGGCTC	ExciteL6
GTGGAGAAGATGGCAC	Astrocytes
GTGGAGAAGCTAGATA	ExciteNP
GTGGAGACAAACCACT	ExciteL6
GTGGAGACAGGCGATA	MOLs
GTGGAGAGTATTAAGG	Endo
GTGGAGATCAACCGAT	MOLs
GTGGAGATCATGAGTC	MOLs
GTGGAGATCGCCAGAC	ExciteL6
GTGGCGTAGTCGGGAT	ExciteL6
GTGGCGTAGTCTGCAT	ExciteL4
GTGGCGTCAAGATGGC	MOLs
GTGGCGTCATCCGAAT	Astrocytes
GTGGCGTGTTGTGTTG	OPCs
GTGGCGTTCGGCACTG	Microglia
GTGGGAAAGCGGATCA	ExciteL6
GTGGGAAAGGGTCAAC	MOLs
GTGGGAACAATCCTAG	InhibNeuron
GTGGGAACAGCGTGAA	OPCs
GTGGGAACAGCTACTA	MOLs
GTGGGAACATGACTCA	Microglia
GTGGGAACATGTCAGT	ExciteL4
GTGGGAAGTCGCTCGA	ExciteL6
GTGGTTAAGATGAAGG	Microglia
GTGGTTAAGGTTCAGG	COPs
GTGGTTACAGTTGTCA	ExciteL6
GTGGTTAGTGCCTATA	MOLs
GTGGTTAGTGTCTTGA	OPCs
GTGGTTATCAATCCAG	Astrocytes
GTGGTTATCCTACCAC	ExciteL23
GTGTAACCAACCAATC	Microglia
GTGTAACCATGGAATA	OPCs
GTGTCCTCAGACTCTA	ExciteL6
GTGTCCTGTTGGTGTT	MOLs
GTGTCCTTCGTTATCT	ExciteL4
GTGTGATAGTTGCTCA	Ependymal
GTGTGATCAAAGTGTA	Astrocytes
GTGTGATCAACGAGGT	InhibNeuron
GTGTGATCAGAATGTA	ExciteL23
GTGTGATGTGTTCCAA	Microglia
GTGTGGCAGAATCGAT	Microglia
GTGTGGCAGCAGGCTA	MOLs
GTGTGGCAGCTTTGTG	Microglia
GTGTGGCAGTATCTGC	ExciteL4
GTGTGGCCAACCAATC	Microglia
GTGTGGCCAGGTCCCA	ExciteL6
GTGTGGCTCGGACAAG	ExciteNP
GTGTGGCTCGGCACTG	ExciteL6
GTGTTAGCAAAGCAAT	Astrocytes
GTGTTAGCACTAGTAC	ExciteL4
GTGTTAGCAGCTCTGG	MOLs
GTGTTAGGTAGTTAGA	ExciteL4
GTGTTAGTCACCGGGT	NIPCs
GTGTTAGTCAGACCTA	ExciteL6
GTGTTAGTCAGCACCG	ExciteL6
GTGTTAGTCCGGTAGC	NIPCs
GTGTTAGTCTTCGGTC	COPs
GTGTTCCAGACGGAAA	Microglia
GTGTTCCAGCCAGAGT	MOLs
GTGTTCCAGCTGAAGC	Endo
GTGTTCCCAAGAGAGA	MOLs
GTGTTCCCACGCTTAA	MOLs
GTGTTCCCAGACACAG	MOLs
GTGTTCCCATGACAAA	Microglia
GTGTTCCGTACGCTAT	Pericytes
GTGTTCCGTCGATTTG	OPCs
GTGTTCCGTTTACGAC	Microglia
GTGTTCCTCAACTCTT	ExciteL4
GTTACAGAGACGCCAA	Microglia
GTTACAGAGCATCCCG	COPs
GTTACAGAGGGCAATC	Astrocytes
GTTACAGCATACAGCT	Microglia
GTTACAGGTATCGAAA	ExciteL5
GTTACAGGTATCGCTA	InhibNeuron
GTTACAGGTCGGCTAC	MOLs
GTTACAGGTCGTCATA	Microglia
GTTACAGTCGCTCCTA	MOLs
GTTACAGTCTAATTCC	Astrocytes
GTTACAGTCTACAGGT	MOLs
GTTACAGTCTGGGCCA	MOLs
GTTACCCAGCCAGAGT	Astrocytes
GTTACCCAGGTAGTCG	ExciteL4
GTTACCCCAAGCGCAA	Astrocytes
GTTACCCCACGTACAT	MOLs
GTTACCCGTAGAGATT	ExciteL4
GTTACCCTCGATTGAC	OPCs
GTTACCCTCGCTAGCG	MOLs
GTTACCCTCTCTGGTC	MOLs
GTTACGAAGGTTTACC	Microglia
GTTACGAAGTAAACTG	MOLs
GTTACGACACTAGTAC	MOLs
GTTACGAGTGGGTATG	OPCs
GTTACGAGTGTTTGCA	OPCs
GTTACGATCGTGACTA	OPCs
GTTACGATCTTGGGCG	ExciteL6
GTTAGACAGCCTGTCG	MOLs
GTTAGACCAGCTCTGG	Microglia
GTTAGACCATTCTTCA	ExciteL4
GTTAGACTCAGTCATG	ExciteL6
GTTAGACTCTCATGGA	ExciteL6
GTTAGTGCAGCGTAGA	Microglia
GTTAGTGCATGGAATA	ExciteL4
GTTAGTGTCGATACGT	COPs
GTTAGTGTCGTGCATA	Astrocytes
GTTATGGAGTAACGAT	MOLs
GTTATGGCACGTACTA	OPCs
GTTATGGGTGACAGGT	ExciteL4
GTTATGGGTGGTTCTA	MOLs
GTTATGGGTTACACAC	ExciteL4
GTTATGGTCCGTGGGT	ExciteL6
GTTATGGTCGGTCAGC	ExciteL4
GTTCATTAGGCTAAAT	Microglia
GTTCATTAGTTTGAGA	Microglia
GTTCATTCAACCTAAC	ExciteL4
GTTCATTGTCTGCAAT	OPCs
GTTCATTTCAGCTCTC	Macrophages
GTTCATTTCCATGCAA	Astrocytes
GTTCATTTCCGTGTAA	Astrocytes
GTTCATTTCGCCTTGT	Microglia
GTTCATTTCTTACCGC	Microglia
GTTCCGTAGAACGCGT	ExciteL4
GTTCCGTCATCCGAAT	OPCs
GTTCCGTGTATTGCCA	Microglia
GTTCCGTGTCTTCCGT	MOLs
GTTCCGTGTGATAGAT	MOLs
GTTCCGTGTTTAGACC	MOLs
GTTCCGTTCGCACTCT	Astrocytes
GTTCGCTAGCACTAAA	Astrocytes
GTTCGCTAGGAGCTGT	MOLs
GTTCGCTCAAAGCACG	ExciteL6
GTTCGCTCAAGGGTCA	OPCs
GTTCGCTCAAGTAGTA	ExciteL6
GTTCGCTCATCTGTTT	Microglia
GTTCGCTGTATACAGA	MOLs
GTTCGCTTCCTCACTG	ExciteL4
GTTCTATAGACCAAAT	ExciteL4
GTTCTATAGAGTGTTA	MOLs
GTTCTATCATCCCGTT	Astrocytes
GTTCTATGTATCAAGA	COPs
GTTCTATGTCTCAAGT	ExciteL4
GTTCTATGTGTGGTCC	Astrocytes
GTTCTATTCACTCGAA	ExciteL5
GTTGAACAGTCACGCC	ExciteL4
GTTGAACCAACCCTAA	Microglia
GTTGAACCAATTTCTC	MOLs
GTTGAACCATACTGTG	InhibNeuron
GTTGAACGTACAGCGA	ExciteL4
GTTGAACGTGACTCTA	Astrocytes
GTTGAACTCATTGGTG	OPCs
GTTGAACTCGCCAGTG	ExciteL4
GTTGAACTCGGATACT	Microglia
GTTGAACTCTGCTAGA	MOLs
GTTGCGGAGACTACGG	NIPCs
GTTGCGGAGCCGTTGC	Microglia
GTTGCGGCAAAGAACT	Microglia
GTTGCGGGTCAAAGAT	ExciteL4
GTTGCGGTCCTAGCTC	Astrocytes
GTTGCGGTCGTGAGAG	InhibNeuron
GTTGCGGTCTATGTGG	ExciteL4
GTTGCGGTCTGCGGAC	MOLs
GTTGCTCAGCTTAAGA	Microglia
GTTGCTCCAAGACCTT	ExciteL4
GTTGCTCCAAGACGGT	Astrocytes
GTTGCTCGTGGAGGTT	InhibNeuron
GTTGCTCTCGCTGTTC	OPCs
GTTGCTCTCTCCTGCA	Microglia
GTTGCTCTCTGCCTCA	Macrophages
GTTGTAGAGAAGAACG	ExciteL4
GTTGTAGAGAAGCCAC	Microglia
GTTGTAGGTGCCTGCA	Astrocytes
GTTGTAGGTGGCTGCT	OPCs
GTTGTAGTCTCTGAGA	OPCs
GTTGTAGTCTGTTCAT	ExciteL23
GTTGTCCAGCCTCAAT	ExciteL6
GTTGTCCAGCTGACTT	OPCs
GTTGTCCAGGAAGTCC	ExciteL6
GTTGTCCCAAACACCT	ExciteL4
GTTGTCCCAATTGGTC	ExciteL4
GTTGTCCGTTACACTG	ExciteL23
GTTGTGAAGACTGAGC	OPCs
GTTGTGAAGCGACTTT	MOLs
GTTGTGAAGTTCATGC	Astrocytes
GTTGTGAGTAGCTGTT	MOLs
GTTGTGATCTAATTCC	Microglia
GTTTACTCAACAGCCC	InhibNeuron
GTTTACTCAGGCCTGT	ExciteL6
GTTTACTCAGGGAGAG	ExciteL23
GTTTACTCATTCTTCA	Microglia
GTTTACTGTAATTGGA	Microglia
GTTTACTTCACAATGC	ExciteL4
GTTTACTTCACACCGG	Microglia
GTTTACTTCCTGTAAG	ExciteL4
GTTTACTTCTGCTTAT	ExciteL4
GTTTGGAAGCACTAGG	ExciteL6
GTTTGGAAGCTCCCTT	ExciteL4
GTTTGGACACAGCCTG	ExciteL6
GTTTGGATCAGCTAGT	OPCs
GTTTGGATCGTTCCCA	Microglia
TAACACGAGCGATGAC	Endo
TAACACGGTGATTCAC	Astrocytes
TAACACGGTTGGACTT	MOLs
TAACACGTCCATTTAC	Microglia
TAACCAGAGAATTGCA	OPCs
TAACCAGAGCATTTCG	MOLs
TAACCAGAGGAACGCT	Microglia
TAACCAGAGGATTTAG	MOLs
TAACCAGAGGCATCGA	OPCs
TAACCAGCAAACCATC	OPCs
TAACCAGCAGGGAGAG	Astrocytes
TAACCAGGTGAGATTA	MOLs
TAACCAGGTGTAGGAC	ExciteL4
TAACGACAGGTAAGGA	ExciteL6
TAACGACCACGTGAGA	OPCs
TAACGACCAGCTGTAT	ExciteL6
TAACGACGTAATCAAG	Microglia
TAACGACGTCACTACA	Astrocytes
TAACGACTCTCGACGG	OPCs
TAACTTCAGGATTTCC	ExciteL6
TAACTTCCAATTCTCT	COPs
TAACTTCCATGGTACT	OPCs
TAACTTCGTCAGGCAA	MOLs
TAACTTCGTCATTGCA	ExciteL4
TAACTTCGTCCCTGAG	MOLs
TAACTTCTCAAGTCTG	Microglia
TAACTTCTCTGGCCAG	ExciteL6
TAAGCACAGTTACTCG	OPCs
TAAGCACGTCCAATCA	Astrocytes
TAAGCACGTGGTCCCA	ExciteL6
TAAGCACTCGGCCAAC	COPs
TAAGCCAAGATGACAT	Endo
TAAGCCAAGCATCTTG	NIPCs
TAAGCCAAGGTCCCTG	ExciteL23
TAAGCCACAATGTTGC	Astrocytes
TAAGCCACACCGGAAA	COPs
TAAGCCACAGCCCACA	MOLs
TAAGCCAGTCCGGTGT	ExciteL4
TAAGCCAGTGGTAATA	MFOLs
TAAGCCATCACTGCTC	OPCs
TAAGCGTAGAGGGCGA	MOLs
TAAGCGTCAGCACAGA	ExciteL5
TAAGCGTCATGGGAAC	Astrocytes
TAAGCGTTCCCTGGTT	MOLs
TAAGCGTTCCCTTGTG	ExciteL6
TAAGCGTTCCGTGGTG	InhibNeuron
TAAGCGTTCTCAATCT	ExciteL4
TAAGTCGAGAGTGACC	MOLs
TAAGTCGAGCTGACCC	InhibNeuron
TAAGTCGCACCTGCTT	ExciteL5
TAAGTCGCAGTCGAGA	Microglia
TAAGTCGGTACAGAGC	COPs
TAAGTCGTCCAAATGC	ExciteL4
TAAGTCGTCCCGTTCA	Astrocytes
TAAGTCGTCGATGGAG	ExciteL4
TAAGTCGTCGGTTGTA	OPCs
TAAGTCGTCTGAGGCC	Microglia
TAATCTCAGATGAATC	ExciteL4
TAATCTCAGGTTGGTG	MOLs
TAATCTCAGTCGAAGC	Astrocytes
TAATCTCCAGCTGTGC	ExciteL6
TAATCTCCATCGCTGG	Pericytes
TAATCTCCATGACAAA	Microglia
TAATCTCGTCAAGCCC	ExciteL4
TAATCTCGTGGGATTG	Microglia
TAATCTCTCAAAGCCT	Macrophages
TAATCTCTCAAGCCGC	Microglia
TAATCTCTCACCACAA	Endo
TAATCTCTCATCTGTT	MOLs
TAATCTCTCTTCTAAC	Microglia
TAATTCCAGAATAACC	ExciteL6
TAATTCCAGAGGCCAT	ExciteL4
TAATTCCAGCTGTGCC	Astrocytes
TAATTCCAGGGCTAAC	ExciteL5
TAATTCCCAAAGCTCT	OPCs
TAATTCCCAAAGGAGA	NIPCs
TAATTCCCACCAGTAT	ExciteL6
TAATTCCTCAAACCCA	Astrocytes
TAATTCCTCGATCCAA	NIPCs
TAATTCCTCGCGTGAC	ExciteL4
TACAACGAGGCAGTCA	ExciteL23
TACAACGCAGAAGCTG	Microglia
TACAACGCAGCAGTTT	Microglia
TACAACGGTCTTTATC	Astrocytes
TACAACGTCTGAATGC	MOLs
TACACCCAGGAGAGTA	Microglia
TACACCCAGGTTATAG	MOLs
TACACCCTCATGCGGC	Microglia
TACACCCTCCATAGGT	COPs
TACACCCTCTTGTTAC	ExciteL6
TACAGGTAGCTGTCCG	ExciteL6
TACAGGTCACAAGCTT	ExciteL6
TACAGGTCAGAAATCA	ExciteL23
TACAGGTCAGCTCATA	ExciteL4
TACAGGTCAGGAATCG	OPCs
TACAGGTGTGGCGCTT	ExciteL5
TACAGGTGTTGAGAGC	ExciteL6
TACAGGTTCCACTTCG	Astrocytes
TACAGGTTCCGCACGA	Microglia
TACAGGTTCGGCATAT	Microglia
TACATTCAGGGATCAC	ExciteL23
TACATTCGTACAGAGC	ExciteL4
TACATTCTCATCGTAG	ExciteL4
TACATTCTCTATCGCC	ExciteL5
TACCCACAGAGAGAAC	Microglia
TACCCACAGCACACAG	Astrocytes
TACCCACAGGCAGGTT	OPCs
TACCCACAGGCATCGA	COPs
TACCCACCAGCGTATT	ExciteL5
TACCCACGTCTCCTGT	Microglia
TACCCACTCATTCTTG	MOLs
TACCCACTCCGAACGC	MOLs
TACCCACTCGAAGCAG	Astrocytes
TACCCACTCTTCACAT	OPCs
TACCCGTAGGTAAGAG	ExciteL6
TACCCGTAGTATGCAA	ExciteL6
TACCCGTCACCTGATA	ExciteL6
TACCCGTCACGCAAAG	ExciteL6
TACCCGTCAGTAACGG	Astrocytes
TACCCGTGTCCAGAAG	Microglia
TACCCGTGTGGTTTGT	ExciteL23
TACCCGTTCACGAGGA	Microglia
TACCCGTTCATGAGGG	Astrocytes
TACCCGTTCTCCGATC	NIPCs
TACCGAAAGACTCATC	ExciteL23
TACCGAAAGCAACTCT	Microglia
TACCGAAAGCGAACTG	MOLs
TACCGAAGTCCGAAGA	ExciteL5
TACCGAAGTCCGGTGT	ExciteL23
TACCGAATCACGGGAA	Microglia
TACCGGGCAGCTATAC	MOLs
TACCGGGCATAGATGA	Astrocytes
TACCGGGCATTCAGCA	MOLs
TACCGGGTCCTCACGT	Microglia
TACCTCGAGGTGTGAC	Microglia
TACCTCGAGTTTCAGC	MOLs
TACCTCGCACGACAGA	COPs
TACCTCGCATAACAGA	Microglia
TACCTCGCATTCAGGT	Microglia
TACCTCGGTGTCGCTG	COPs
TACCTCGTCAGTCTTT	ExciteL6
TACCTCGTCGTGCGAC	Microglia
TACCTGCAGGTCTACT	MOLs
TACCTGCCAAGTTCCA	Astrocytes
TACCTGCCAGTCGAGA	NIPCs
TACCTGCGTACTAAGA	Pericytes
TACCTGCGTCGATTCA	ExciteL6
TACCTGCGTGCGGATA	Microglia
TACCTGCGTTGGCCGT	ExciteL4
TACCTGCTCACACCGG	Astrocytes
TACCTGCTCCTACTGC	OPCs
TACCTGCTCGACGTCG	OPCs
TACCTGCTCGCACTCT	Astrocytes
TACGCTCAGAATACAC	ExciteL6
TACGCTCCAAGTTCCA	Astrocytes
TACGCTCGTCTTCTAT	Endo
TACGCTCGTTGTGTAC	ExciteL6
TACGGGCAGATGACCG	Astrocytes
TACGGGCAGCCAGAGT	ExciteL23
TACGGGCAGCCTCTTC	ExciteL5
TACGGGCCAGGAAGTC	Microglia
TACGGGCCATCTTAGG	Microglia
TACGGGCGTGACTAAA	Astrocytes
TACGGGCTCAACCTCC	OPCs
TACGGTAAGGATCATA	ExciteL5
TACGGTATCATTCCTA	ExciteL4
TACGGTATCCATCTCG	OPCs
TACGGTATCCGTTTCG	MOLs
TACGGTATCGTGCAGC	ExciteL6
TACGTCCCAGATACCT	OPCs
TACGTCCGTAACCCTA	ExciteL6
TACGTCCGTCTAGGTT	ExciteL6
TACTGCCAGAAGAGCA	ExciteL6
TACTGCCAGCACGGAT	Microglia
TACTGCCAGCGATGAC	MOLs
TACTGCCAGCTGAAAT	ExciteL6
TACTGCCAGGCACTAG	Microglia
TACTGCCAGGCCTAGA	MOLs
TACTGCCAGTGGACGT	OPCs
TACTGCCCACGGCCAT	MOLs
TACTGCCCAGTGTATC	ExciteL4
TACTGCCTCAAGATAG	Microglia
TACTGCCTCACTACGA	OPCs
TACTGCCTCAGAACCT	MOLs
TACTGCCTCCACCTCA	Microglia
TACTGCCTCCAGTTCC	MOLs
TACTGCCTCCCTCGAT	ExciteL4
TACTGCCTCCGAGTGC	Astrocytes
TACTGCCTCGGAGTGA	COPs
TACTTACCACTAAACC	ExciteL23
TACTTACGTACCCGCA	MOLs
TACTTACGTGACGTCC	Microglia
TACTTACGTTAGCTAC	MOLs
TACTTACTCAGTGTCA	InhibNeuron
TACTTACTCTTGCAGA	ExciteL6
TACTTCAGTGTCGATT	Microglia
TACTTCATCGACCACG	ExciteL5
TACTTCATCTATTCGT	Microglia
TACTTCATCTCCCATG	ExciteL4
TACTTGTCATCGTGGC	Astrocytes
TACTTGTGTAGACAGC	Microglia
TACTTGTTCTCTGCCA	MOLs
TAGACCAAGATGGCAC	NIPCs
TAGACCAAGCAACAGC	COPs
TAGACCACACAAGCAG	MOLs
TAGACCACAGAATCGG	Astrocytes
TAGACCACAGACATCT	Microglia
TAGACCACAGATTAAG	Microglia
TAGACCAGTGTCCGGT	NIPCs
TAGACCATCAGTGTCA	Astrocytes
TAGACTGAGCGGGTAT	InhibNeuron
TAGACTGCACACACGC	Microglia
TAGACTGCAGCAGGAT	Astrocytes
TAGACTGGTGGCACTC	ExciteL4
TAGACTGTCAACTCTT	Microglia
TAGACTGTCCATGAGT	OPCs
TAGACTGTCGACACTA	Astrocytes
TAGACTGTCGTCGACG	MOLs
TAGAGTCCATCGGATT	ExciteL5
TAGAGTCGTACAAGCG	Microglia
TAGAGTCTCGACATTG	Astrocytes
TAGATCGAGCTTTCTT	Microglia
TAGATCGCATAATCGC	MOLs
TAGATCGGTACCAGAG	ExciteL4
TAGATCGTCCGATAAC	Microglia
TAGCACACACGCCAGT	ExciteL6
TAGCACAGTGGGTCAA	ExciteL23
TAGCACATCATGACAC	ExciteL4
TAGCACATCTTCTGTA	Microglia
TAGGAGGAGACCATTC	ExciteL4
TAGGAGGAGCCTCGTG	ExciteL4
TAGGAGGAGCTGCCAC	COPs
TAGGAGGAGGATCACG	MOLs
TAGGAGGCAATTCACG	Microglia
TAGGAGGCAGCGGTCT	Astrocytes
TAGGAGGCAGGATCTT	InhCajalRetzius
TAGGAGGCATGAGAAT	ExciteL4
TAGGAGGTCCCATGGG	COPs
TAGGAGGTCGGAGTGA	OPCs
TAGGAGGTCGTTCTGC	OPCs
TAGGGTTAGCATAGGC	Microglia
TAGGGTTAGTAAGGGA	InhibNeuron
TAGGGTTAGTGCAGGT	ExciteL6
TAGGGTTCAATCACGT	Microglia
TAGGGTTCAGTTAGGG	Microglia
TAGGGTTCATCACAGT	COPs
TAGGGTTGTGGCTACC	Astrocytes
TAGGGTTTCACACGAT	NIPCs
TAGGGTTTCCCAGTGG	ExciteL6
TAGGTACAGATGTTAG	Microglia
TAGGTACAGTTCTACG	MOLs
TAGGTACCAACGTAAA	Astrocytes
TAGGTACTCTCAGTCC	ExciteL4
TAGGTACTCTGAACGT	ExciteL6
TAGGTTGCACGTTCGG	COPs
TAGGTTGCACTAGAGG	ExciteL4
TAGGTTGGTAGTGATA	Microglia
TAGGTTGGTTTCGTTT	ExciteL4
TAGGTTGTCAGCATTG	ExciteL6
TAGTGCAAGACATATG	MOLs
TAGTGCAAGGTCGTGA	Microglia
TAGTGCACACATGGTT	ExciteL4
TAGTGCACAGAGGTAC	MOLs
TAGTGCACAGAGTTCT	MFOLs
TAGTGCACATCCTCAC	ExciteL4
TAGTGCACATTGCTGA	Microglia
TAGTGCAGTGGCGTAA	ExciteL4
TAGTGCATCGTCAGAT	ExciteL23
TAGTGCATCGTTCTAT	Astrocytes
TATACCTAGCTAATCC	MOLs
TATACCTAGTTTCGGT	MOLs
TATACCTCAGAACATA	MOLs
TATACCTCATCTGCGG	OPCs
TATACCTCATTGTCGA	MOLs
TATACCTGTCATTCCC	ExciteL23
TATACCTGTGACAACG	ExciteL6
TATACCTGTTTGCCGG	MOLs
TATACCTTCATGAGTC	ExciteL4
TATATCCAGACCGCCT	OPCs
TATATCCAGCCAGAGT	Microglia
TATATCCCAAGAGTTA	MOLs
TATATCCCACACCGCA	Astrocytes
TATATCCCACCCATAA	ExciteL4
TATATCCCAGGAGGAG	Astrocytes
TATATCCGTGCCTATA	Microglia
TATATCCGTGGAAATT	MOLs
TATATCCGTTCCCAAA	Astrocytes
TATCAGGAGATGCAGC	Microglia
TATCAGGAGCTATCCA	MOLs
TATCAGGAGTCTCCTC	MOLs
TATCAGGGTCCCGTGA	Astrocytes
TATCAGGGTCTCAGAT	Microglia
TATCAGGGTGAAGCTG	MOLs
TATCAGGGTTCCGCAG	Astrocytes
TATCAGGGTTTACGAC	MOLs
TATCAGGTCCACGTCT	Microglia
TATCAGGTCGGATACT	MOLs
TATCAGGTCTTCCGTG	MOLs
TATCCTAAGCAACTTC	MOLs
TATCCTAAGCGGGTTA	ExciteL6
TATCCTAAGGGAGTGG	ExciteL23
TATCCTAAGTCTCGTA	MOLs
TATCCTACAAAGAACT	ExciteL6
TATCCTACACTAACCA	Microglia
TATCGCCAGCCAACCC	Astrocytes
TATCGCCAGTGCCTCG	Astrocytes
TATCGCCAGTGCGTCC	Microglia
TATCGCCAGTTGCGCC	MOLs
TATCGCCCACCGAATT	MOLs
TATCGCCCACGCCAGT	MOLs
TATCGCCCACGTATAC	Astrocytes
TATCGCCCAGCTACCG	Microglia
TATCGCCCATGACACT	ExciteL6
TATCGCCGTCCTCAGG	MOLs
TATCGCCGTGCTCTTC	Astrocytes
TATCGCCGTGTTCGAT	OPCs
TATCGCCGTTAGGGAC	OPCs
TATCGCCTCCGACAGC	Microglia
TATCTGTAGAAGGCTC	ExciteL4
TATCTGTAGGAAGTCC	Microglia
TATCTGTCAACAGTGG	MOLs
TATCTGTCAACATCGT	ExciteL4
TATCTGTGTGTTGAGG	ExciteL4
TATCTGTTCGACGATT	COPs
TATCTTGAGCCACAAG	Microglia
TATCTTGAGGACGCAT	Microglia
TATCTTGAGTTGTCGT	ExciteL4
TATCTTGCACCTGTCT	ExciteL4
TATCTTGCATCGATAC	Microglia
TATCTTGCATCGTGGC	ExciteL4
TATCTTGTCAAACCCA	ExciteL4
TATCTTGTCAAGCTTG	Astrocytes
TATCTTGTCTGCAGCG	OPCs
TATCTTGTCTGTCGCT	Microglia
TATGTTCAGCCTTCTC	OPCs
TATGTTCAGTATAGGT	Microglia
TATGTTCCAAGTACCT	OPCs
TATGTTCCACATACTG	ExciteL4
TATGTTCCATCGAAGG	Pericytes
TATGTTCGTATCGGTT	Astrocytes
TATGTTCGTCCTCATC	ExciteL6
TATGTTCGTCGTCATA	MOLs
TATGTTCTCAACTGAC	Astrocytes
TATTCCAAGTAGACCG	ExciteL4
TATTCCAGTATCATGC	Endo
TATTCCAGTCAACCTA	ExciteL6
TATTCCAGTGACTCGC	MOLs
TATTCCAGTGTTTCTT	InhibNeuron
TATTCCAGTTATCTGG	ExciteL4
TATTCCAGTTGGAGGT	ExciteL23
TATTCCATCACGGAGA	COPs
TATTGCTAGAAGTCCG	Microglia
TATTGCTAGCAGGGAG	ExciteNP
TATTGCTAGGGATCTG	MOLs
TATTGCTCAATTAGGA	Astrocytes
TATTGCTCATCGTCCT	OPCs
TATTGCTGTGAGATCG	COPs
TATTGCTTCAGCACCG	ExciteL4
TATTGCTTCGTCGGGT	Microglia
TATTGGGAGCCTCTCT	MOLs
TATTGGGCATAGGCGA	Pericytes
TATTGGGGTATACCCA	ExciteL6
TATTGGGGTGTCTTAG	Microglia
TATTGGGTCGGCTTCT	Microglia
TATTTCGAGACGCCCT	ExciteL6
TATTTCGAGTCATTGC	ExciteL4
TATTTCGCAGTAGAGC	OPCs
TATTTCGGTAAGTTAG	MOLs
TATTTCGGTACAATAG	ExciteL4
TATTTCGGTGATGAAT	OPCs
TATTTCGTCCATAGAC	ExciteL23
TCAAGACAGCACAAAT	ExciteL23
TCAAGACAGTAGCCAG	Astrocytes
TCAAGACAGTCTGGTT	InhibNeuron
TCAAGACCAGTGCCTG	Microglia
TCAAGACCATCATCCC	Astrocytes
TCAAGACGTCACGTGC	ExciteL6
TCAAGACGTCGTCTCT	Endo
TCAAGCAAGAATCTAG	Microglia
TCAAGCAAGACTAGAT	MOLs
TCAAGCAAGAGCCTGA	Microglia
TCAAGCAAGGAGTACC	MOLs
TCAAGCAAGTTTCAGC	MOLs
TCAAGCAGTTCCTACC	Microglia
TCAAGCATCCACACCT	ExciteL6
TCAAGCATCTCCGTGT	Microglia
TCAAGCATCTGCAGCG	OPCs
TCAAGTGAGAATGTTG	MOLs
TCAAGTGAGCATACTC	Microglia
TCAAGTGAGTGATGGC	Microglia
TCAAGTGCAAAGCTAA	MOLs
TCAAGTGCACGAGGTA	InhibNeuron
TCAAGTGCAGTTAGGG	MOLs
TCAAGTGGTACAAGTA	Astrocytes
TCAAGTGGTAGGCTGA	Macrophages
TCAAGTGGTCTCTCTG	ExciteL4
TCAAGTGGTTTACCTT	ExciteL6
TCAAGTGGTTTCACTT	ExciteL4
TCAAGTGTCCTACGGG	ExciteL5
TCAAGTGTCGTAATGC	MOLs
TCAATCTCAGAACATA	ExciteL5
TCAATCTCAGGTTCGC	MOLs
TCAATCTGTCGATTAC	Microglia
TCAATCTGTCTACGAT	OPCs
TCAATCTGTTCGGACC	COPs
TCAATCTTCCATCGTC	ExciteL4
TCAATTCAGACGCCAA	ExciteL23
TCAATTCAGAGGCGTT	ExciteL23
TCAATTCAGGTACAAT	ExciteL4
TCAATTCCACAAATGA	MOLs
TCAATTCCATCTAACG	ExciteNP
TCAATTCGTCATAACC	ExciteL4
TCAATTCGTCGTTGCG	MOLs
TCAATTCTCGTGTGGC	OPCs
TCAATTCTCTCGTGAA	ExciteNP
TCACAAGAGACGGTTG	OPCs
TCACAAGCAAATGGAT	ExciteL4
TCACAAGCATCGGAGA	Astrocytes
TCACAAGGTACCTAGT	ExciteL4
TCACAAGGTGCAAGAC	Microglia
TCACAAGGTTCGCGTG	OPCs
TCACAAGTCCACCCTA	ExciteL4
TCACACCAGAATTTGG	ExciteL4
TCACACCAGGCCCAAA	ExciteL5
TCACACCAGGCTTAGG	ExciteL6
TCACACCGTCCGAAGA	ExciteL4
TCACATTAGCCAACCC	ExciteL6
TCACATTAGGGACAGG	Microglia
TCACATTCAACGGGTA	OPCs
TCACATTCACCCTTGT	Microglia
TCACATTGTCCTGAAT	Astrocytes
TCACATTGTGGAACCA	MOLs
TCACATTGTGTTAACC	ExciteL6
TCACATTGTTTCGACA	OPCs
TCACATTTCTAGCCAA	Microglia
TCACATTTCTGAGGCC	ExciteL4
TCACGCTCAATTGTGC	ExciteL6
TCACGCTCACGATTCA	MOLs
TCACGCTCATGAATAG	ExciteL23
TCACGCTGTCCAAGAG	Microglia
TCACGCTTCAGCAATC	MOLs
TCACGCTTCCAAATGC	COPs
TCACGCTTCCCAAGTA	ExciteL4
TCACGGGAGCGCCTAC	Astrocytes
TCACGGGAGGTCGTAG	InhibNeuron
TCACGGGCAATTGGTC	OPCs
TCACGGGCAGACTCTA	ExciteL6
TCACGGGCAGCGATTT	NIPCs
TCACGGGCAGGTTTAC	ExciteL4
TCACGGGCATAGTCGT	OPCs
TCACGGGGTAACAAGT	ExciteL4
TCACGGGGTATCACCA	Microglia
TCACGGGGTGATACCT	MOLs
TCACTATCAAACCATC	ExciteL6
TCACTATCATGTGGCC	ExciteL5
TCACTATGTACCGTCG	Astrocytes
TCACTATGTAGCTGTT	Microglia
TCACTATGTAGGATAT	Microglia
TCACTATGTTTCTATC	ExciteL6
TCACTATGTTTCTTAC	Microglia
TCACTATTCAGCTTCC	MOLs
TCACTATTCCAGCTCT	MOLs
TCACTCGTCCAGCTCT	ExciteL4
TCACTCGTCTAGTGAC	Microglia
TCAGCAAAGACATATG	Microglia
TCAGCAAAGTGCAAAT	InhibNeuron
TCAGCCTAGCTGCGAA	Microglia
TCAGCCTAGTATCTGC	ExciteNP
TCAGCCTGTCACAGAG	OPCs
TCAGCCTGTGATCGTT	OPCs
TCAGCCTTCGGCTTCT	ExciteL4
TCAGGGCCAAGAGAGA	Microglia
TCAGGGCCACAAAGTA	InhibNeuron
TCAGGGCCAGCGGTCT	MOLs
TCAGGGCGTTTACGAC	OPCs
TCAGGGCTCGGAATTC	OPCs
TCAGGGCTCGGACGTC	MOLs
TCAGGGCTCGTCCATC	OPCs
TCAGGGCTCTCAGTCC	ExciteL6
TCAGGTAAGCATCGAG	MOLs
TCAGGTAAGGCGATAC	Microglia
TCAGGTACAAAGGCTG	Microglia
TCAGGTACAAGCCATT	MOLs
TCAGGTACAAGGTCTT	ExciteL4
TCAGGTACACTTGGCG	Pericytes
TCAGGTAGTGAAAGTT	Microglia
TCAGTCCAGAATCGCG	ExciteL4
TCAGTCCAGGTAATCA	OPCs
TCAGTCCAGGTCGTCC	ExciteL6
TCAGTCCAGTAATTGG	OPCs
TCAGTCCCAAGCTGCC	Astrocytes
TCAGTCCGTAAGATAC	MOLs
TCAGTCCGTTCCTAGA	Endo
TCAGTCCGTTGATCGT	ExciteNP
TCAGTCCGTTGGAGGT	ExciteL4
TCAGTCCTCAAGTTGC	ExciteL4
TCAGTGAAGATGACCG	Astrocytes
TCAGTGAAGGAGACCT	ExciteL5
TCAGTGACAAGTGCAG	Astrocytes
TCAGTGACACTCATAG	OPCs
TCAGTGAGTCAGTTTG	MOLs
TCAGTGAGTGCCTATA	InhibNeuron
TCAGTGAGTTCGGCGT	Microglia
TCAGTGATCGTGGCTG	ExciteL4
TCAGTTTAGTTTCAGC	COPs
TCAGTTTCAGCATCTA	InhibNeuron
TCAGTTTGTATACCCA	OPCs
TCAGTTTGTGCCGAAA	ExciteL5
TCAGTTTTCTTTCCAA	ExciteL6
TCATACTAGAGAAGGT	Macrophages
TCATACTGTACAGAGC	Microglia
TCATACTGTGAAAGTT	ExciteNP
TCATACTTCAGTGTGT	Astrocytes
TCATACTTCTCGCTTG	MOLs
TCATATCAGAGCGACT	MOLs
TCATATCAGTCACGCC	ExciteL4
TCATATCAGTTGCGAG	ExciteL4
TCATATCCAATTGCGT	ExciteL6
TCATATCCAGCTACCG	ExciteL6
TCATATCGTCGTTGCG	MOLs
TCATATCGTTGGCCGT	ExciteL6
TCATATCGTTTCGTTT	Microglia
TCATCATAGTTTCTTC	ExciteNP
TCATCATCACCGTCGA	Microglia
TCATCATCAGAGAGGG	ExciteNP
TCATCATGTACGATGG	ExciteL5
TCATCATGTCCTCCAT	ExciteL6
TCATCATGTCGCCACA	MOLs
TCATCATTCGGTCGGT	Microglia
TCATCCGAGGGCCCTT	ExciteL4
TCATCCGAGTGCGTCC	ExciteL4
TCATCCGTCGCTGACG	Microglia
TCATCCGTCTACGCGG	ExciteNP
TCATGAGGTCCCTAAA	ExciteL23
TCATGAGGTCCTTAAG	Microglia
TCATGAGGTTGCCAAT	ExciteL23
TCATGAGTCGACTCCT	MOLs
TCATGCCAGCATACTC	ExciteL4
TCATGCCCACATACTG	Astrocytes
TCATGCCCAGTAACCT	ExciteL23
TCATGCCCATCCAACA	OPCs
TCATGCCGTTGTGTAC	ExciteL4
TCATGCCTCAGCCCAG	MOLs
TCATGGACAGAGATGC	ExciteL6
TCATGGACAGGACTAG	OPCs
TCATGGAGTAAGGAGA	Microglia
TCATGGAGTCGGTGTC	Microglia
TCATGGAGTGGAATGC	Pericytes
TCATGGATCAAGTGGG	MOLs
TCATGGATCGGCCTTT	NIPCs
TCATGTTAGGATTTGA	ExciteL6
TCATGTTAGTCTGCAT	ExciteL4
TCATGTTGTACCAATC	MOLs
TCATGTTGTAGACAAT	ExciteL4
TCATGTTTCCCTCGTA	OPCs
TCATGTTTCTTGAGCA	OPCs
TCATTACAGAGCAACC	ExciteL4
TCATTACAGAGTTGAT	Astrocytes
TCATTACCACGCACCA	MOLs
TCATTACCACTTTATC	Astrocytes
TCATTACGTTGGACTT	COPs
TCATTACTCATTTCGT	Microglia
TCATTACTCCATGCAA	COPs
TCATTACTCGACTCCT	ExciteL23
TCATTACTCGTTGTTT	MOLs
TCATTACTCTCAATCT	OPCs
TCATTCAAGGGTGAAA	Microglia
TCATTCAAGTGATCGG	MOLs
TCATTCAAGTGTGTTC	MOLs
TCATTCACAACCGACC	Microglia
TCATTCACAAGTACCT	Pericytes
TCATTCACAGCTACAT	ExciteL6
TCATTCACAGTCAGTT	Microglia
TCATTCACATAGGCGA	Astrocytes
TCATTCACATCATTGG	ExciteL6
TCATTCACATTGACTG	Microglia
TCATTCATCCATGATG	InhibNeuron
TCATTCATCCGCTTAC	ExciteL4
TCATTCATCTTGGATG	ExciteL5
TCATTGTAGAGCGACT	OPCs
TCATTGTAGCTTCTAG	ExciteL6
TCATTGTAGTGATAGT	Microglia
TCATTGTGTATCGTGT	Microglia
TCATTGTTCTCAACCC	Microglia
TCATTTGAGATACATG	ExciteL5
TCATTTGAGTACTCGT	ExciteL4
TCATTTGAGTAGACCG	ExciteL6
TCATTTGCACACGGAA	COPs
TCATTTGCAGGCGAAT	ExciteL6
TCATTTGGTGACCGTC	ExciteL4
TCATTTGTCCCTCTAG	ExciteL6
TCCACCAAGCCTTTGA	Astrocytes
TCCACCACAAGTCCCG	ExciteL4
TCCACCAGTATTTCGG	MOLs
TCCACCATCAGTGATC	MOLs
TCCACCATCTGGAGAG	ExciteL6
TCCACGTAGACAGCTG	ExciteL6
TCCACGTCAACCCGCA	ExciteL4
TCCACGTCACGAGGAT	ExciteL4
TCCACGTCAGAACATA	InhibNeuron
TCCACGTCAGACTGCC	ExciteL4
TCCACGTGTCGTACAT	OPCs
TCCACGTGTGGTACAG	ExciteL4
TCCACGTTCAGGCGAA	Astrocytes
TCCACGTTCCTCTCGA	OPCs
TCCAGAAAGCAATAGT	Microglia
TCCAGAACACGACAGA	Astrocytes
TCCAGAACATGGAACG	Microglia
TCCAGAAGTAGCCCTG	Microglia
TCCAGAAGTCCAAAGG	MOLs
TCCAGAAGTGCCGGTT	Microglia
TCCAGAATCAAATAGG	MOLs
TCCATCGAGAGCAAGA	ExciteL6
TCCATCGAGCCACTCG	Microglia
TCCATCGAGGTTTACC	ExciteL6
TCCATCGCAAGCGGAT	Astrocytes
TCCATCGGTCTGGTTA	ExciteNP
TCCATCGGTTGCATCA	OPCs
TCCATCGTCGAACACT	MOLs
TCCATGCAGAAGGTAG	InhibNeuron
TCCATGCAGAGCCCAA	Microglia
TCCATGCAGCTGCCAC	Astrocytes
TCCATGCAGTGGTGGT	ExciteL4
TCCATGCCAGCTCTGG	ExciteL6
TCCATGCCATCGATGT	MOLs
TCCATGCCATCGCCTT	Astrocytes
TCCATGCGTGTCCAAT	MOLs
TCCATGCGTGTCTCCT	Pericytes
TCCCACAGTCTCGGAC	ExciteL5
TCCCACAGTGCATTTG	Microglia
TCCCACATCCGGCAAC	ExciteL4
TCCCAGTAGCTAGCCC	ExciteL23
TCCCAGTAGGGAGTTC	Pericytes
TCCCAGTCACGATAGG	ExciteL4
TCCCAGTCAGTTAGAA	Microglia
TCCCAGTCATGAGAAT	ExciteL6
TCCCAGTGTCCTCCAT	InhibNeuron
TCCCAGTGTGATACTC	Astrocytes
TCCCAGTTCCATCAGA	Microglia
TCCCAGTTCCATTTGT	Microglia
TCCCAGTTCCTTCGAC	Microglia
TCCCAGTTCTACACTT	NIPCs
TCCCATGAGAATCGCG	ExciteL6
TCCCATGAGACTGAGC	OPCs
TCCCATGAGATTCGCT	Astrocytes
TCCCATGAGGATTCAA	Endo
TCCCATGAGGCTGAAC	Microglia
TCCCATGCATTGAAGA	ExciteL6
TCCCATGGTCCTACAA	ExciteL6
TCCCATGGTGACACAG	ExciteL4
TCCCATGTCGGCCTTT	ExciteL4
TCCGAAAAGAACTGAT	InhibNeuron
TCCGAAAAGTCAGCGA	Astrocytes
TCCGAAACACTTGACA	Pericytes
TCCGAAACATCCTCAC	MOLs
TCCGAAATCCGATCGG	ExciteL4
TCCGAAATCTGCGGAC	ExciteNP
TCCGATCAGAACTCCT	OPCs
TCCGATCAGCAGGTCA	InhibNeuron
TCCGATCCACACACGC	InhibNeuron
TCCGATCCACGACCTG	ExciteL23
TCCGGGAAGGTACCTT	MOLs
TCCGGGACACAAGTTC	Microglia
TCCGGGACACTATGTG	Microglia
TCCGGGAGTATGAAAC	OPCs
TCCGGGAGTCCACATA	ExciteL4
TCCGGGAGTGGCTTAT	Astrocytes
TCCGGGAGTGTAGCAG	Microglia
TCCGGGAGTTGATGTC	ExciteL6
TCCGGGAGTTGTACGT	MOLs
TCCGGGATCATACAGC	Astrocytes
TCCGGGATCCCAACTC	OPCs
TCCGGGATCGGAATGG	Microglia
TCCGTGTCACGGGTAA	ExciteL4
TCCGTGTCAGTGTGCC	InhibNeuron
TCCGTGTGTAGGTGCA	InhibNeuron
TCCGTGTGTCATATGC	Microglia
TCCGTGTGTCCTGTCT	ExciteL23
TCCGTGTTCCACCTCA	ExciteL6
TCCGTGTTCGCGAAGA	Astrocytes
TCCGTGTTCTTCGTAT	ExciteL4
TCCTAATAGACTCATC	MOLs
TCCTAATAGCTTCATG	Endo
TCCTAATCACTGCATA	Astrocytes
TCCTAATCATCGATAC	Microglia
TCCTAATCATCGGCCA	InhibNeuron
TCCTAATGTCGAGTTT	ExciteL23
TCCTAATTCCAGCAAT	Astrocytes
TCCTCCCAGGGACAGG	MOLs
TCCTCCCCATGTTCGA	MOLs
TCCTCCCGTCTGTGCG	ExciteL4
TCCTCCCGTGACTGAG	ExciteL6
TCCTCCCGTGCATCTA	OPCs
TCCTCCCGTTGTAGCT	OPCs
TCCTCCCTCACTTGTT	OPCs
TCCTCCCTCGAAGCAG	Microglia
TCCTCGAAGAAGTATC	MOLs
TCCTCGAAGTGGTTAA	Astrocytes
TCCTCGACAGGGTCTC	NIPCs
TCCTCGACATCGAACT	ExciteNP
TCCTCGAGTATAGCTC	ExciteL4
TCCTCGATCGTAGTGT	InhibNeuron
TCCTCGATCGTCCTTG	ExciteL6
TCCTCGATCTACCAGA	Microglia
TCCTCTTAGAAGGCTC	ExciteL4
TCCTCTTAGCGACTGA	Microglia
TCCTCTTAGTGAGGTC	ExciteL4
TCCTCTTCACCAGTAT	ExciteL6
TCCTCTTCACTTCAGA	Microglia
TCCTCTTCAGCAGACA	MOLs
TCCTCTTCAGCTGGTC	ExciteL5
TCCTGCAAGAATAACC	MOLs
TCCTGCAGTACAGAAT	ExciteL4
TCCTGCAGTTGGGATG	MOLs
TCCTTCTAGCGACTTT	Astrocytes
TCCTTCTAGCGTCTGC	Microglia
TCCTTCTAGTGGATTA	Microglia
TCCTTCTCAAACTAAG	OPCs
TCCTTCTCACCCTTGT	ExciteL4
TCCTTCTCATCGTCCT	Astrocytes
TCCTTCTGTAGATTAG	ExciteL4
TCCTTCTTCCTTTAGT	ExciteL5
TCCTTCTTCGTTCTGC	MOLs
TCCTTCTTCTTACTGT	Endo
TCCTTTCAGAGAATCT	MOLs
TCCTTTCAGTCAACAA	ExciteL23
TCCTTTCAGTTGCGAG	InhibNeuron
TCCTTTCCACCAGCTG	OPCs
TCCTTTCCACGCACCA	Microglia
TCCTTTCGTACGATGG	ExciteNP
TCCTTTCGTCACTTAG	Microglia
TCCTTTCGTCATAACC	NIPCs
TCCTTTCGTGTGACCC	ExciteL4
TCCTTTCGTTAGGCTT	Endo
TCCTTTCGTTCTCGTC	COPs
TCCTTTCGTTGACTAC	MOLs
TCCTTTCTCCGAGTGC	ExciteL6
TCCTTTCTCGGAGATG	NIPCs
TCCTTTCTCTCGGGAC	ExciteL4
TCGAACAAGCAATTCC	Astrocytes
TCGAACAAGGACAGTC	Microglia
TCGAACAGTGGATACG	COPs
TCGAACAGTGTGATGG	OPCs
TCGAACATCATCGCAA	Microglia
TCGAACATCCTGTACC	Microglia
TCGAACATCGTGCATA	Microglia
TCGAAGTAGACATCAA	ExciteL5
TCGAAGTAGATAGCTA	ExciteL23
TCGAAGTCAATTGAAG	ExciteL6
TCGAAGTGTATTTCCT	Astrocytes
TCGAAGTGTGCCTATA	ExciteNP
TCGAAGTTCCCTTGTG	ExciteL6
TCGAAGTTCGTAGTGT	Microglia
TCGACCTAGCCGAATG	COPs
TCGACCTAGCTACGTT	ExciteL4
TCGACCTAGGGTTGCA	Astrocytes
TCGACCTCACCCTGTT	Astrocytes
TCGACCTCATTCGATG	COPs
TCGACCTGTAGAAACT	Astrocytes
TCGACCTGTTTCACAG	ExciteL4
TCGACGGAGAGAACCC	Microglia
TCGACGGAGAGTGAAG	MOLs
TCGACGGAGCTTGTGT	ExciteL23
TCGACGGCAGAGACTG	MOLs
TCGACGGCATTACTCT	InhibNeuron
TCGACGGGTACTGCCG	Macrophages
TCGACGGGTCCTGGGT	MOLs
TCGACGGGTGTCCACG	Microglia
TCGACGGTCCGCTAGG	MOLs
TCGATTTAGACCACGA	ExciteL23
TCGATTTCAAGACAAT	MOLs
TCGATTTGTGTCCGTG	MOLs
TCGATTTGTTGTGTAC	Astrocytes
TCGATTTTCAATGCAC	Microglia
TCGCACTAGCACTTTG	ExciteL23
TCGCACTAGTTTGGCT	Microglia
TCGCACTCAACATACC	MOLs
TCGCACTGTAACCCTA	ExciteL6
TCGCACTGTCCAGCCA	MOLs
TCGCACTGTGGCCTCA	OPCs
TCGCACTGTTAAAGTG	ExciteL4
TCGCACTGTTCGAACT	InhibNeuron
TCGCAGGCAACAGCCC	MOLs
TCGCAGGCAGATTAAG	ExciteL4
TCGCAGGCATATGAAG	ExciteL4
TCGCAGGGTCCCAAAT	MOLs
TCGCAGGTCGCCGAGT	OPCs
TCGCTCAAGATGACAT	Microglia
TCGCTCACAACGATTC	MOLs
TCGCTCACAACGTATC	Microglia
TCGCTCACACACACGC	InhibNeuron
TCGCTCAGTCACCACG	Microglia
TCGCTCATCCTTCTAA	Microglia
TCGCTCATCGAGATAA	Endo
TCGCTCATCTGGGCCA	MOLs
TCGCTTGAGCGCCTAC	Astrocytes
TCGCTTGAGGCTCTCG	MOLs
TCGCTTGAGTTGGCGA	MOLs
TCGCTTGGTCATCCGG	ExciteL4
TCGCTTGGTCCGCAGT	Astrocytes
TCGCTTGGTCCTTAAG	ExciteNP
TCGCTTGTCTCCCATG	ExciteL5
TCGGATAAGACAGTCG	OPCs
TCGGATAAGCATGATA	OPCs
TCGGATACAAGCACCC	MOLs
TCGGATACAAGGTCGA	ExciteL4
TCGGATACAGATCCTA	ExciteNP
TCGGATAGTATGTGTC	InhibNeuron
TCGGATATCAATCCAG	OPCs
TCGGATATCGAGTACT	ExciteNP
TCGGATATCGTTCAGA	Microglia
TCGGATATCTCTATAC	ExciteL4
TCGGATATCTGAACGT	ExciteL6
TCGGATATCTGATGGT	OPCs
TCGGATATCTTGGCTC	Microglia
TCGGGACAGGATTCAA	MOLs
TCGGGACCAAACTGCT	COPs
TCGGGACGTCCTCAGG	OPCs
TCGGGACGTGATAGTA	ExciteL6
TCGGGACTCCAAACCA	Microglia
TCGGGACTCGATGCTA	ExciteL4
TCGGGCAAGCTACGTT	Microglia
TCGGGCAAGGTTTACC	OPCs
TCGGGCACACCCTATC	ExciteL4
TCGGGCACAGTGGTGA	OPCs
TCGGGCACATTAGGAA	ExciteL4
TCGGGCAGTCCACAGC	Microglia
TCGGGCAGTCCTGTCT	MOLs
TCGGGCAGTTATGTCG	ExciteL4
TCGGGCATCATACGAC	COPs
TCGGGCATCCGTATAG	Microglia
TCGGGCATCGTACACA	OPCs
TCGGGTGAGACCATGG	ExciteL6
TCGGGTGAGATAGCTA	MOLs
TCGGGTGCAACAGAGC	COPs
TCGGGTGCACAAATGA	Microglia
TCGGGTGCACCGCTGA	ExciteL4
TCGGGTGGTGAGTTTC	COPs
TCGGGTGGTTGGTGTT	MOLs
TCGGTCTAGACGGAAA	Astrocytes
TCGGTCTCAATTGGTC	MOLs
TCGGTCTCACTCAGAT	MOLs
TCGGTCTGTAATGCGG	ExciteL6
TCGGTCTGTCTTACTT	ExciteL4
TCGGTCTGTGCATACT	ExciteL5
TCGGTCTTCAAGGACG	ExciteL23
TCGGTCTTCCGGTTCT	MOLs
TCGGTCTTCCTACCGT	OPCs
TCGTAGAAGACTAAGT	Microglia
TCGTAGAAGCGGTAAC	MOLs
TCGTAGAAGGTTGGTG	InhibNeuron
TCGTAGACATAGGTAA	Microglia
TCGTAGAGTCCAGCCA	Microglia
TCGTAGAGTGCTTCAA	ExciteL6
TCGTAGAGTGTTATCG	NIPCs
TCGTAGATCGCAACAT	Microglia
TCGTCCAAGAGGGTCT	MOLs
TCGTCCAAGTGAACAT	ExciteNP
TCGTCCACAGGTGAGT	Astrocytes
TCGTCCACATTCGATG	OPCs
TCGTCCAGTGTGTGGA	Astrocytes
TCGTCCATCCACCTGT	ExciteL6
TCGTGCTAGCGCCTTG	ExciteL4
TCGTGCTCACCTTCGT	ExciteL6
TCGTGCTGTAAGGAGA	ExciteNP
TCGTGCTGTTCACCGG	OPCs
TCGTGCTTCCTCTCTT	ExciteL23
TCGTGCTTCTCGGGAC	ExciteNP
TCGTGGGAGGAACGCT	MOLs
TCGTGGGCACGAGGAT	Microglia
TCGTGGGCAGCCATTA	MOLs
TCGTGGGCATAGGTTC	OPCs
TCTAACTAGCACTCTA	Microglia
TCTAACTAGCAGGCTA	ExciteL4
TCTAACTCAGAAATTG	Astrocytes
TCTAACTCAGCACAGA	OPCs
TCTAACTCAGGTTCAT	MOLs
TCTAACTCATACCGTA	InhibNeuron
TCTAACTGTACGATTC	ExciteL6
TCTAACTTCAACGTGT	Astrocytes
TCTAACTTCATCTCTA	Astrocytes
TCTAACTTCCATGCAA	Endo
TCTACATAGCCATTCA	Astrocytes
TCTACATAGGTTCAGG	OPCs
TCTACATAGTTGAAAC	ExciteL5
TCTACATCAAGTGGGT	ExciteL4
TCTACATCAAGTTGGG	Astrocytes
TCTACATCAATTCTCT	MOLs
TCTACATGTAGTAAGT	Astrocytes
TCTACATGTGTGCCTG	Astrocytes
TCTACATGTTGCCGCA	ExciteL6
TCTACATTCGTCGACG	ExciteL23
TCTACCGAGTGTCATC	ExciteL4
TCTACCGCAGCTACAT	InhibNeuron
TCTACCGGTAAGGCTG	MOLs
TCTATACCAGTTGTTG	Astrocytes
TCTATACCATTAAGCC	MOLs
TCTATACGTATGAAAC	Astrocytes
TCTATACGTCAAGCCC	ExciteL4
TCTATACGTGCGAACA	Microglia
TCTATACTCACCTGTC	MOLs
TCTATACTCACTCCGT	ExciteL6
TCTATACTCCCTCAAC	COPs
TCTATACTCGACGCGT	Astrocytes
TCTATCAAGGGCCTCT	Microglia
TCTATCAAGTTTCGGT	MOLs
TCTATCACAAGGCTTT	ExciteL4
TCTATCACAATCGCGC	ExciteL6
TCTATCACACTTCAAG	MOLs
TCTATCACAGCCTTCT	MOLs
TCTATCAGTGATAGAT	ExciteL23
TCTATCAGTTAATCGC	MOLs
TCTATCATCAAGGACG	InhibNeuron
TCTATCATCCAGGACC	InhibNeuron
TCTCACGCAATCTAGC	ExciteL4
TCTCACGGTGAAAGTT	Astrocytes
TCTCACGTCTGCGTCT	InhibNeuron
TCTCAGCAGGCGCTCT	ExciteL4
TCTCAGCCACTTGACA	Microglia
TCTCAGCCATCATGAC	ExciteL6
TCTCAGCCATCGAGCC	ExciteL4
TCTCAGCGTGGCAACA	ExciteL6
TCTCAGCTCGGATACT	Endo
TCTCAGCTCTTCCCGA	MOLs
TCTCAGCTCTTTGCGC	Astrocytes
TCTCCGAAGAACTGAT	ExciteL5
TCTCCGAAGAATTGCA	MOLs
TCTCCGAAGCTACGTT	MOLs
TCTCCGACAAGTCGTT	Astrocytes
TCTCCGACACGACAGA	ExciteNP
TCTCCGACAGACCATT	ExciteL6
TCTCCGACAGCACAGA	ExciteL4
TCTCCGACAGTATACC	Astrocytes
TCTCCGAGTCTCTCTG	OPCs
TCTCCGAGTCTGCGCA	Microglia
TCTCCGATCACTGTTT	ExciteL6
TCTCCGATCCTAGCTC	MOLs
TCTCCGATCCTTCTGG	MOLs
TCTCTGGAGAGCACTG	MOLs
TCTCTGGAGTTGTAAG	ExciteL4
TCTCTGGCAAAGGCGT	ExciteL6
TCTCTGGCAAGATCCT	Microglia
TCTCTGGCAATGAGCG	ExciteNP
TCTCTGGCACTCACTC	Microglia
TCTCTGGCACTTACAG	ExciteL23
TCTCTGGCAGACCTAT	Endo
TCTCTGGCATGGCTGC	ExciteL4
TCTCTGGTCAACCGAT	ExciteNP
TCTCTGGTCCAACCAA	ExciteL4
TCTCTGGTCCAATCCC	InhibNeuron
TCTCTGGTCGTCCATC	MOLs
TCTGCCAAGGTCATCT	ExciteL4
TCTGCCAAGTAGCTCT	COPs
TCTGCCAAGTCACGAG	Microglia
TCTGCCAAGTGCACTT	NIPCs
TCTGCCACACCTCAGG	Microglia
TCTGCCACATCTGTTT	Microglia
TCTGCCAGTACCGTGC	Microglia
TCTGCCAGTATGTGTC	OPCs
TCTGCCAGTTTGGGAG	Ependymal
TCTGCCATCACTGTTT	Pericytes
TCTGCCATCTCTTAAC	MOLs
TCTGGCTAGATTGACA	ExciteL4
TCTGGCTAGCAAGCCA	ExciteNP
TCTGGCTAGCGTCAAG	ExciteL6
TCTGGCTAGCTGAGTG	NIPCs
TCTGGCTAGGACACTG	MOLs
TCTGGCTAGGCCATAG	OPCs
TCTGGCTAGGTCATAA	ExciteL6
TCTGGCTCAGCTTCGG	NIPCs
TCTGGCTTCTCGCAGG	Microglia
TCTGTCGAGACCATAA	InhibNeuron
TCTGTCGCAACCCTAA	ExciteL6
TCTGTCGCAGCTATTG	ExciteL4
TCTGTCGTCACGTCCT	Macrophages
TCTGTCGTCTGTGCTC	Astrocytes
TCTGTCGTCTTAGGAC	Microglia
TCTTAGTAGGGAGTTC	Microglia
TCTTAGTAGTTGCCCG	ExciteL23
TCTTAGTCAGGAGGTT	ExciteL4
TCTTAGTGTCACTTCC	OPCs
TCTTAGTGTCCAGAAG	ExciteL6
TCTTAGTGTCCGGCAT	OPCs
TCTTAGTGTTGTACGT	ExciteL6
TCTTCCTAGAGCATTA	MOLs
TCTTCCTAGCGCCGTT	MOLs
TCTTCCTAGGACCCAA	NIPCs
TCTTCCTCACCTCTAC	MOLs
TCTTCCTCACGAGGTA	Microglia
TCTTCCTGTACTAAGA	Astrocytes
TCTTCCTGTCAATCTG	ExciteL23
TCTTCCTGTCGCACAC	ExciteL6
TCTTCCTTCAAGTGTC	MOLs
TCTTCCTTCCCTCAAC	Astrocytes
TCTTCCTTCTACGGGC	OPCs
TCTTCCTTCTATCGCC	ExciteL6
TCTTGCGAGATACATG	Microglia
TCTTGCGAGGTCCGAA	MOLs
TCTTGCGAGGTTCCAT	ExciteL6
TCTTGCGCAAAGCAAT	ExciteL4
TCTTGCGCAGATTTCG	MOLs
TCTTGCGGTACTCAAC	MOLs
TCTTGCGTCACTTATC	MOLs
TCTTTGAAGAGATTCA	ExciteL5
TCTTTGACAAAGGCTG	MOLs
TCTTTGACAAGCTGCC	OPCs
TCTTTGACAATTGCCA	ExciteL4
TCTTTGACATAGAGGC	Microglia
TCTTTGAGTCACCCTT	Astrocytes
TCTTTGAGTCGTTGGC	Microglia
TCTTTGAGTTAGGACG	ExciteL5
TCTTTGAGTTGCAACT	Astrocytes
TCTTTGAGTTGCATTG	MOLs
TCTTTGAGTTTCCATT	COPs
TCTTTGATCCCTTTGG	MOLs
TGAACGTAGAGTCGAC	InhibNeuron
TGAACGTCACAAGTGG	InhibNeuron
TGAACGTCACAATTCG	ExciteL5
TGAACGTCATCACGGC	ExciteL23
TGAACGTGTCGGCCTA	ExciteL4
TGAACGTGTGAACCGA	MOLs
TGAACGTGTGACAGGT	ExciteL6
TGAACGTGTGCAATGG	MOLs
TGAACGTTCGGAGCAA	MOLs
TGAATCGAGGAGTCTG	ExciteL6
TGAATCGCACGGGTAA	ExciteL6
TGAATCGGTTCTCTCG	OPCs
TGAATCGTCGTAGTCA	Microglia
TGAATGCAGCAGATAT	ExciteL23
TGAATGCAGCAGGCAT	COPs
TGAATGCAGCGCACAA	ExciteL23
TGAATGCAGTATAGAC	Microglia
TGAATGCAGTTAACAG	Microglia
TGAATGCCAACAAGTA	NIPCs
TGAATGCGTCAAAGCG	InhibNeuron
TGAATGCGTTAGAAGT	OPCs
TGAATGCTCAGAGCGA	ExciteL4
TGAATGCTCCAGTGTA	COPs
TGAATGCTCGAGAATA	InhibNeuron
TGACAGTAGACCGCCT	Microglia
TGACAGTAGCCATGCC	Microglia
TGACAGTAGTCAATCC	ExciteL4
TGACAGTAGTTTGGCT	MOLs
TGACAGTCAATCTCGA	Microglia
TGACAGTCATCTGGGC	Astrocytes
TGACAGTTCGGCATTA	MOLs
TGACCCTAGTGGCAGT	Microglia
TGACCCTAGTTCATCG	OPCs
TGACCCTCATCTGCGG	OPCs
TGACCCTGTAGCCAGA	InhibNeuron
TGACCCTGTCACTTAG	OPCs
TGACCCTGTGGTCTAT	ExciteL4
TGACCCTTCGTACCTC	OPCs
TGACGCGAGCGACCCT	Pericytes
TGACGCGAGTAGACCG	ExciteL6
TGACGCGCACGGTAGA	MOLs
TGACTCCAGCCTAACT	ExciteL5
TGACTCCAGGATGTTA	ExciteL6
TGACTCCAGGTTCTAC	ExciteL4
TGACTCCAGTTGGACG	OPCs
TGACTCCCATTCCTCG	MOLs
TGACTCCGTGGACCAA	Microglia
TGACTCCTCCTAAGTG	ExciteL4
TGAGACTAGAACAAGG	MOLs
TGAGACTAGAGCAGCT	ExciteL6
TGAGACTGTCACTAGT	MOLs
TGAGACTGTCTCGACG	ExciteL23
TGAGACTGTTCAATCG	Microglia
TGAGACTGTTCATCTT	OPCs
TGAGACTTCATAAGGA	Microglia
TGAGCATAGCTCTATG	Microglia
TGAGCATAGGTCATAA	ExciteL4
TGAGCATAGTCGAATA	Microglia
TGAGCATCAGTGTGCC	ExciteL6
TGAGCATCATAATCCG	Astrocytes
TGAGCATGTAATGATG	ExciteNP
TGAGCATGTGTACATC	NIPCs
TGAGCATTCTCTCGCA	ExciteL4
TGAGCATTCTTACTGT	ExciteL5
TGAGCATTCTTTGCAT	Astrocytes
TGAGCGCCAACGCCCA	ExciteL4
TGAGCGCCATGTAACC	ExciteL6
TGAGCGCGTCCGGCAT	Microglia
TGAGCGCTCCATACTT	Microglia
TGAGCGCTCCCTTGGT	ExciteL4
TGAGCGCTCGGTAGGA	ExciteL6
TGAGGAGAGCTCAGAG	MOLs
TGAGGAGCACTTTAGG	MOLs
TGAGGAGCATGCCGGT	ExciteL4
TGAGGAGGTAGGAGTC	OPCs
TGAGGAGGTCTTTCAT	ExciteL23
TGAGGAGGTTAAGCAA	Microglia
TGAGGAGGTTGGGATG	Microglia
TGAGGAGTCCCGAATA	ExciteL6
TGAGGGAAGGCCTTGC	ExciteL6
TGAGGGAAGTAGGATT	ExciteL6
TGAGGGAAGTGACACG	MOLs
TGAGGGAAGTTGAATG	ExciteL23
TGAGGGACAACAGCCC	MOLs
TGAGGGACAAGTCCAT	OPCs
TGAGGGAGTGGCTCTG	MOLs
TGAGGGATCCTAAGTG	Endo
TGAGGGATCTAAGAAG	ExciteL23
TGAGGGATCTGGCTGG	ExciteNP
TGAGGGATCTTCCAGC	COPs
TGAGGTTAGCTACTGT	Astrocytes
TGAGGTTCACTCTAGA	ExciteL4
TGAGGTTCAGTCAACT	ExciteL4
TGAGGTTCATCTCATT	ExciteL4
TGAGGTTGTATCCTCC	ExciteL6
TGAGGTTGTCATTGCA	Microglia
TGAGGTTGTGTCATTG	Astrocytes
TGAGGTTTCAAGCTGT	Pericytes
TGAGGTTTCCGTAATG	COPs
TGAGGTTTCCTGCTAC	InhibNeuron
TGAGTCACACCTCAGG	Microglia
TGAGTCACAGTCCCGA	ExciteL4
TGAGTCACATCCGATA	InhibNeuron
TGAGTCAGTATCGTGT	MOLs
TGAGTCAGTCCGTTTC	ExciteL4
TGAGTCAGTGTCTTAG	ExciteL23
TGAGTCAGTTGTATGC	ExciteL23
TGAGTCATCACTTCTA	Endo
TGAGTCATCATTGCTT	Microglia
TGATCAGAGCGTGTCC	ExciteL6
TGATCAGCAATAGAGT	OPCs
TGATCAGCACGACGTC	COPs
TGATCAGCATATCTCT	Endo
TGATCAGGTCATCACA	OPCs
TGATCAGGTCCGAAGA	Macrophages
TGATCAGGTCCGACGT	COPs
TGATCAGGTCCGTACG	Microglia
TGATCAGGTGAATAAC	ExciteNP
TGATCAGTCCTTATGT	ExciteL4
TGATCTTAGCCGATTT	COPs
TGATCTTAGGCCTAAG	MOLs
TGATCTTCAAGCCATT	OPCs
TGATCTTCACAAGCCC	MOLs
TGATCTTCAGTATACC	ExciteL23
TGATCTTCATCACCAA	Microglia
TGATCTTGTCTGTGGC	Microglia
TGATCTTTCTCGCAGG	OPCs
TGATGCAAGAAACTGT	Astrocytes
TGATGCAAGAGTCCGA	ExciteL23
TGATGCAAGAGTGTGC	ExciteL4
TGATGCAAGCGACCCT	ExciteL4
TGATGCAAGGTAAGAG	ExciteL23
TGATGCAAGTGGTTAA	NIPCs
TGATGCACACCGTGGT	Microglia
TGATGCACATTCATCT	MOLs
TGATGCACATTCTTCA	MOLs
TGATGCAGTAAGCGGT	Microglia
TGATGCAGTCGGAAAC	ExciteL5
TGATGCATCGTGGCTG	ExciteL4
TGATGCATCTCAACCC	COPs
TGATGGTAGTATGTAG	ExciteL4
TGATGGTCAGCGACAA	ExciteL4
TGATGGTCAGGACATG	MOLs
TGATGGTGTCTAACGT	ExciteL6
TGATGGTGTGCGTTTA	ExciteL23
TGATTCTAGTTACGGG	Astrocytes
TGATTCTCAAGCCCAC	MOLs
TGATTCTTCATGTCAG	Microglia
TGATTCTTCGACCCAG	Endo
TGATTCTTCTGCCTCA	Microglia
TGATTTCAGGAGAATG	Astrocytes
TGATTTCAGGTTGACG	ExciteL6
TGATTTCCAACACAGG	InhibNeuron
TGATTTCCATTGGCAT	NIPCs
TGATTTCGTCATCAGT	MOLs
TGATTTCTCCATTCGC	NIPCs
TGATTTCTCGATGCAT	Microglia
TGCACGGAGAAGCGCT	Microglia
TGCACGGAGAGTGTTA	MOLs
TGCACGGAGTATTGCC	MOLs
TGCACGGCAATCGCGC	Microglia
TGCACGGCAATTGAAG	Astrocytes
TGCACGGGTTCTCGCT	Macrophages
TGCACGGTCCGATTAG	ExciteL5
TGCAGATAGCGACTTT	ExciteL6
TGCAGATAGGACAAGA	Microglia
TGCAGATCAATTGCTG	ExciteL6
TGCAGATCACGCGCTA	Microglia
TGCAGATGTAACCCTA	ExciteNP
TGCAGATGTATGGGAC	MOLs
TGCAGATTCGTTATCT	Astrocytes
TGCAGATTCTCCCATG	ExciteL6
TGCAGGCAGATCCGAG	Microglia
TGCAGGCCAGGTTCGC	OPCs
TGCAGGCGTGTAGGAC	InhibNeuron
TGCAGGCTCATCACCC	NIPCs
TGCAGGCTCTCCCATG	ExciteL6
TGCAGTAAGACCCGCT	Astrocytes
TGCAGTACAGCATTGT	MOLs
TGCAGTAGTACCGCGT	ExciteL4
TGCAGTAGTCTACAGT	MOLs
TGCAGTAGTGAGGAAA	MOLs
TGCAGTAGTGCAGTGA	COPs
TGCAGTAGTGTCATCA	ExciteL4
TGCAGTAGTTGGACCC	ExciteL6
TGCAGTATCCTATTTG	Microglia
TGCATCCAGAAGCCAC	ExciteL23
TGCATCCAGCAACAAT	OPCs
TGCATCCAGCTGCCAC	MOLs
TGCATCCAGGCAGCTA	Microglia
TGCATCCGTCCCGGTA	Microglia
TGCATCCGTTAGTCGT	ExciteL23
TGCATCCGTTTCGGCG	MOLs
TGCATCCTCAGATTGC	InhibNeuron
TGCATCCTCCAGTACA	Astrocytes
TGCATGAAGAGCAACC	Microglia
TGCATGACACAGTATC	ExciteL4
TGCATGACAGAGACTG	MOLs
TGCATGACAGTTGTTG	InhibNeuron
TGCATGAGTACGATCT	Microglia
TGCATGAGTTCAACGT	Astrocytes
TGCATGATCACTCGAA	Microglia
TGCATGATCATCGGGC	MOLs
TGCATGATCCATTCAT	MOLs
TGCCGAGAGGGACTGT	MOLs
TGCCGAGAGGGAGATA	MOLs
TGCCGAGAGTCCCAAT	MOLs
TGCCGAGAGTGAACAT	MOLs
TGCCGAGCAATACGAA	ExciteL4
TGCCGAGCACACCAGC	Microglia
TGCCGAGCACATTACG	ExciteL4
TGCCGAGCACTAAACC	ExciteL4
TGCCGAGCAGGGAGAG	Astrocytes
TGCCGAGGTCCACAGC	Microglia
TGCCGAGTCACAACCA	ExciteL6
TGCGACGGTAACTGCT	ExciteL4
TGCGACGGTACAGGTG	Astrocytes
TGCGACGGTCTCTCTG	Microglia
TGCGACGTCAAAGACA	Fibroblasts
TGCGACGTCTGGACTA	Microglia
TGCGATAAGAGCATTA	InhibNeuron
TGCGATAAGTGGTTAA	ExciteL23
TGCGATACAAGCACCC	OPCs
TGCGATACATACTTTC	ExciteL4
TGCGATACATCGGAAG	ExciteL6
TGCGGCAAGAGGGTAA	MOLs
TGCGGCAAGAGTTCGG	Microglia
TGCGGCAAGCCTATCA	ExciteL4
TGCGGCACATTACTCT	ExciteL6
TGCGGCAGTAGGCAAC	OPCs
TGCGGCAGTATCGATC	ExciteL4
TGCGGCAGTCGAATGG	ExciteL23
TGCGGCATCCGTCAAA	ExciteL23
TGCGGGTAGAGTTGCG	Astrocytes
TGCGGGTAGCAGCCTC	ExciteL6
TGCGGGTCACAGTATC	ExciteL6
TGCGGGTCAGTTGAAA	Microglia
TGCGGGTGTTGTAGCT	OPCs
TGCTCCACACATATCG	ExciteL6
TGCTCCACACCCTAGG	OPCs
TGCTCCAGTTTCTATC	Microglia
TGCTCCATCACTACGA	Endo
TGCTCCATCCCTTGGT	ExciteL5
TGCTCCATCCGAAATC	ExciteL6
TGCTCCATCTGGGATT	MOLs
TGCTCGTAGCGACAGT	Microglia
TGCTCGTAGGGCCTCT	MOLs
TGCTCGTTCGAACCAT	ExciteL6
TGCTCGTTCGAGAATA	COPs
TGCTCGTTCGCTGTTC	Pericytes
TGCTGAAAGGACAGTC	ExciteL5
TGCTGAACATGTTACG	Microglia
TGCTGAAGTCTACGTA	OPCs
TGCTGAAGTGAGGAAA	OPCs
TGCTGAAGTTCAAGGG	Microglia
TGCTGAATCATAGAGA	OPCs
TGCTGAATCATATGGC	ExciteL6
TGCTGAATCCACATAG	ExciteL6
TGCTGAATCCGTCACT	ExciteL6
TGCTTCGAGTATGAGT	MOLs
TGCTTCGAGTTGTCAC	ExciteL4
TGCTTCGCACCTCAGG	Microglia
TGCTTCGCATCACCAA	Astrocytes
TGCTTCGCATGTTACG	MOLs
TGCTTCGGTCCCTGAG	MOLs
TGCTTCGGTGTAGTGG	COPs
TGCTTCGTCACAAGGG	ExciteNP
TGCTTCGTCCATTGCC	ExciteL4
TGCTTCGTCCGCAGTG	ExciteL5
TGCTTGCCACAAGCAG	MOLs
TGCTTGCCATAAGATG	Microglia
TGCTTGCCATTCTTCA	ExciteL6
TGCTTGCGTCCTTGTC	MOLs
TGCTTGCGTTACTCAG	OPCs
TGCTTGCTCTAGGCCG	InhibNeuron
TGCTTGCTCTTAGTTC	NIPCs
TGGAACTAGCACCAGA	ExciteL4
TGGAACTAGTAAATGC	Microglia
TGGAACTAGTCATGCT	Microglia
TGGAACTCACAAATGA	Microglia
TGGAACTCACTGGACC	ExciteNP
TGGAACTCAGGAATAT	ExciteL4
TGGAACTGTGCTAGCC	ExciteL5
TGGAACTGTTAACCTG	ExciteL6
TGGAACTGTTATGGTC	ExciteL23
TGGAACTTCTATCCAT	OPCs
TGGAGAGAGATTAGTG	ExciteL23
TGGAGAGAGCAATAGT	ExciteNP
TGGAGAGAGGGTTAGC	MOLs
TGGAGAGAGTGCCAGA	MOLs
TGGAGAGCAGCGTGCT	ExciteL5
TGGAGAGCATAATGAG	Microglia
TGGAGAGGTAGCGATG	ExciteL4
TGGAGAGGTTAGAGAT	OPCs
TGGAGAGGTTCTCACC	ExciteL4
TGGAGAGTCGCTTTAT	ExciteL6
TGGAGAGTCTAGTGAC	Microglia
TGGAGAGTCTGAGTCA	Endo
TGGAGAGTCTTACCAT	ExciteL23
TGGAGGAAGGCTCTAT	InhibNeuron
TGGAGGAAGTATCTGC	ExciteL23
TGGAGGAAGTCGGCAA	ExciteL4
TGGAGGACAATTCACG	InhibNeuron
TGGAGGACACGGATCC	Pericytes
TGGAGGACACTTTAGG	Astrocytes
TGGAGGACATGTGGTT	MOLs
TGGAGGAGTATGAAGT	MOLs
TGGAGGAGTCTCCCTA	Microglia
TGGAGGATCAAGCTTG	ExciteL6
TGGAGGATCCCTTCCC	ExciteNP
TGGATCAAGATAGTCA	Microglia
TGGATCAAGGCTCTCG	ExciteL4
TGGATCACAACGGCTC	Microglia
TGGATCACACTCGATA	InhCajalRetzius
TGGATCACATCGCTGG	MOLs
TGGATCATCACACCCT	Microglia
TGGATGTAGAAGAGCA	Microglia
TGGATGTGTCCTCATC	MOLs
TGGATGTGTCGTGGTC	Astrocytes
TGGATGTGTTGGACCC	MOLs
TGGATGTTCTTTCCAA	ExciteL4
TGGCGTGAGGATAATC	MOLs
TGGCGTGCAGGACGAT	ExciteL4
TGGCGTGGTCTTGCTC	Microglia
TGGCGTGGTTAAGACA	Microglia
TGGCGTGTCAGTCATG	ExciteL23
TGGCGTGTCATTGGTG	ExciteL4
TGGCGTGTCGGCCCAA	Microglia
TGGGAAGAGAGGTTTA	ExciteL4
TGGGAAGAGCCTGGAA	Astrocytes
TGGGAAGAGGGTATAT	MOLs
TGGGAAGAGGTTCCGC	Microglia
TGGGAAGCAGCGTGAA	Astrocytes
TGGGAAGCAGTGTATC	ExciteL4
TGGGAAGCATTAGGAA	Microglia
TGGGAAGGTATGAAGT	ExciteL6
TGGGAAGGTGACCGTC	ExciteL23
TGGGAAGTCAGGGATG	MOLs
TGGGAGAAGCGCTTCG	ExciteL4
TGGGAGAAGGGTGGGA	ExciteL6
TGGGAGACAATTCTCT	Microglia
TGGGAGACACAGCTTA	ExciteL4
TGGGAGACAGAGAGGG	ExciteL6
TGGGAGACAGGTGACA	NIPCs
TGGGAGAGTACGAGTG	Astrocytes
TGGGAGAGTCTGTAAC	ExciteL4
TGGGAGAGTTAAGGAT	Microglia
TGGGAGATCTATACGG	OPCs
TGGGAGATCTCCCATG	Microglia
TGGGATTAGGCGAACT	Astrocytes
TGGGATTCACTATCCC	ExciteL4
TGGGATTCAGATCCAT	Astrocytes
TGGGATTGTTTCGTTT	OPCs
TGGGATTTCGTTCTCG	Macrophages
TGGGCGTAGCGTACAG	Astrocytes
TGGGCGTAGTTGCTGT	ExciteL4
TGGGCGTCAACCCGCA	Astrocytes
TGGGCGTCAATTCGTG	Microglia
TGGGCGTCACAGTCGC	ExciteL4
TGGGCGTGTTGAGAGC	Macrophages
TGGGCGTTCATTCGTT	Astrocytes
TGGGCGTTCCCGTTCA	MOLs
TGGGCGTTCGGACTGC	OPCs
TGGGCTGAGGAACTCG	ExciteL4
TGGGCTGAGTTTGTCG	ExciteL23
TGGGCTGCAAGATGGC	Microglia
TGGGCTGCATGCGGTC	MOLs
TGGGCTGCATTGAGCT	OPCs
TGGGCTGGTATAATGG	NIPCs
TGGGCTGGTTCCGCGA	MOLs
TGGGCTGGTTCGATTG	OPCs
TGGGCTGGTTCTAACG	ExciteNP
TGGGCTGGTTGCGTAT	OPCs
TGGGCTGTCCTGGCTT	Microglia
TGGGTTAAGTATAACG	ExciteL4
TGGGTTACAAATAAGC	OPCs
TGGGTTACAGCTGTTA	Astrocytes
TGGGTTACATGACCCG	ExciteL4
TGGGTTAGTAGGTCAG	ExciteL4
TGGGTTAGTGGAACAC	MOLs
TGGGTTATCAAAGGTA	ExciteL6
TGGGTTATCTCGTTTA	Microglia
TGGTACACACCCTTAC	Astrocytes
TGGTACATCCGCCTAT	ExciteL4
TGGTACATCGAGAATA	ExciteL6
TGGTAGTAGCGAACTG	Microglia
TGGTAGTTCCGCAGTG	Astrocytes
TGGTAGTTCTGCTCTG	ExciteL4
TGGTGATAGCTACAAA	Microglia
TGGTGATAGGCGACAT	Microglia
TGGTGATCACATGGTT	OPCs
TGGTGATCACTCCGAG	ExciteL4
TGGTGATCAGACGCTC	OPCs
TGGTGATCATGAGATA	ExciteL4
TGGTGATGTCACCCTT	ExciteL23
TGGTGATGTTCCATTT	ExciteL6
TGGTGATGTTGCATTG	ExciteL4
TGGTGATTCCGTGTGG	Astrocytes
TGGTTAGAGAGCAGTC	ExciteL4
TGGTTAGCACGACGTC	ExciteL6
TGGTTAGCAGATCCAT	MOLs
TGGTTAGCAGCTCTGG	ExciteL4
TGGTTAGGTACATACC	Astrocytes
TGGTTAGGTGTTGACT	ExciteL4
TGGTTAGTCATGCATG	ExciteL4
TGTAACGAGGACCCAA	OPCs
TGTAACGAGGTCACAG	OPCs
TGTAACGAGGTCTGGA	OPCs
TGTAACGCAGAGCTAG	Microglia
TGTAACGGTACGTTCA	Microglia
TGTAACGGTACTAAGA	ExciteL23
TGTAACGGTAGACGTG	ExciteL5
TGTAACGGTTATGGTC	Microglia
TGTAACGGTTCTTGCC	InhibNeuron
TGTAACGTCAGGCGAA	OPCs
TGTAACGTCCCGTGAG	MOLs
TGTAAGCAGCCTCTCT	ExciteL6
TGTAAGCAGGATCACG	ExciteL23
TGTAAGCAGGTGCCTC	COPs
TGTAAGCAGTAAACTG	ExciteL23
TGTAAGCCAGGTGTTT	ExciteL6
TGTAAGCTCGATCCCT	ExciteL4
TGTACAGAGCTATCCA	Microglia
TGTACAGCAGATACTC	ExciteL4
TGTACAGGTTGCCGAC	COPs
TGTACAGTCACTTATC	ExciteL6
TGTACAGTCACTTGGA	COPs
TGTACAGTCGGCATTA	InhibNeuron
TGTAGACAGACCGCCT	ExciteL6
TGTAGACAGAGGCGTT	ExciteL6
TGTAGACAGTACGAGC	ExciteL6
TGTAGACCACGATTCA	OPCs
TGTAGACCAGCACGAA	ExciteL4
TGTAGACGTGACAGGT	OPCs
TGTAGACGTGGGTTGA	ExciteL6
TGTAGACGTGTGTCGC	COPs
TGTAGACTCAAGCTTG	ExciteL4
TGTAGACTCATTGCCC	Astrocytes
TGTAGACTCGATCCAA	ExciteL23
TGTAGACTCTTCTGGC	Astrocytes
TGTCAGAAGCAGGCTA	Microglia
TGTCAGAAGGTAACTA	ExciteL23
TGTCAGACAAAGACTA	InhibNeuron
TGTCAGACAAATCGGG	Pericytes
TGTCAGACAGGAATAT	ExciteL6
TGTCAGACAGGACTAG	ExciteL23
TGTCAGACAGGCTACC	COPs
TGTCAGATCAGCATTG	MOLs
TGTCCACAGGCTCTCG	Microglia
TGTCCACCACAATGCT	ExciteL4
TGTCCACCACGACGTC	Endo
TGTCCACCATACCGTA	OPCs
TGTCCACGTACTCCCT	ExciteL6
TGTCCACGTCTACAAC	Astrocytes
TGTCCACGTGTCCAAT	Astrocytes
TGTCCACTCACAAGAA	Microglia
TGTCCACTCTCGCTTG	COPs
TGTCCCAAGCATGTTC	Microglia
TGTCCCAAGTAAATGC	Pericytes
TGTCCCATCTTCCTAA	Astrocytes
TGTCCTGAGCAGTACG	Microglia
TGTCCTGAGCCTGACC	Macrophages
TGTCCTGAGCTACGTT	COPs
TGTCCTGAGGATATAC	Microglia
TGTCCTGCAGCGAGTA	ExciteL5
TGTCCTGGTACACTCA	COPs
TGTGAGTAGCTGCCTG	Microglia
TGTGAGTAGTGCACCC	Endo
TGTGAGTCACCTTCGT	ExciteL4
TGTGAGTCATCTTCGC	ExciteL4
TGTGAGTTCTTGCAAG	MOLs
TGTGATGAGTGCGTCC	Astrocytes
TGTGATGAGTGGAAGA	Astrocytes
TGTGATGAGTTACTCG	OPCs
TGTGATGTCCCTGGTT	Endo
TGTGATGTCGGCTGTG	OPCs
TGTGCGGAGGATTTAG	Pericytes
TGTGCGGAGGGCCAAT	OPCs
TGTGCGGCAACTTCTT	MOLs
TGTGCGGCAAGATGGC	MOLs
TGTGCGGCACATGACT	ExciteNP
TGTGCGGCACCGGCTA	MOLs
TGTGCGGCAGACCAAG	MOLs
TGTGCGGCAGCCTTCT	ExciteNP
TGTGCGGGTGTTGACT	Astrocytes
TGTGCGGTCCGCACGA	MOLs
TGTGCGGTCGACCTAA	MOLs
TGTGGCGAGAGGTTTA	Astrocytes
TGTGGCGAGAGTCCGA	Microglia
TGTGGCGAGCAAGTCG	MOLs
TGTGGCGAGGACGGAG	Endo
TGTGGCGGTTGGTGTT	Microglia
TGTGGCGTCGTTCGCT	ExciteL6
TGTGTGAAGAGGCCAT	ExciteL23
TGTGTGAAGATAGTGT	MOLs
TGTGTGACACCCTGTT	Astrocytes
TGTGTGACATCGATAC	ExciteL6
TGTGTGATCGAGAGAC	Astrocytes
TGTTACTAGTCGCCCA	InhibNeuron
TGTTACTAGTTTCAGC	Microglia
TGTTACTGTATGGTTC	ExciteL23
TGTTACTGTCTACGAT	ExciteL6
TGTTACTTCCACGTAA	Astrocytes
TGTTACTTCCGGTAAT	ExciteL4
TGTTCATAGATCCGAG	ExciteL6
TGTTCATAGATGGCGT	Microglia
TGTTCATAGCAAACAT	ExciteL23
TGTTCATCATGGAGAC	ExciteNP
TGTTCATGTAAGTCAA	InhibNeuron
TGTTCATGTTCCACGG	Microglia
TGTTCATGTTCCGCGA	ExciteL4
TGTTCCGAGCGCCATC	MOLs
TGTTCCGAGGCTCAAG	Astrocytes
TGTTCCGAGGTGCTTT	ExciteL4
TGTTCCGGTGGTCTTA	ExciteL23
TGTTCCGGTTAGTCGT	MOLs
TGTTCCGGTTGCGTAT	OPCs
TGTTCCGTCCAAACCA	NIPCs
TGTTCCGTCCATTGCC	Microglia
TGTTCCGTCCGCGAGT	ExciteL5
TGTTCCGTCGCACGGT	MOLs
TGTTCCGTCGGTAGAG	ExciteL5
TGTTCCGTCGGTCTGG	ExciteL6
TGTTCTAAGCGATGGT	Microglia
TGTTCTAAGCGGATCA	InhibNeuron
TGTTCTAAGGAACTCG	MOLs
TGTTCTACACCTCTGT	MOLs
TGTTCTACAGCAGTGA	Microglia
TGTTCTAGTAGGAGTC	OPCs
TGTTGAGAGGAAGTGA	ExciteL23
TGTTGAGAGGTTCTAC	Microglia
TGTTGAGGTATGTCAC	Macrophages
TGTTGAGTCCCTTTGG	Microglia
TGTTGAGTCTGTAAGC	Microglia
TGTTGGAAGCAGCCCT	Astrocytes
TGTTGGAAGCCAGAGT	Microglia
TGTTGGAAGTTACGGG	ExciteL4
TGTTGGACAAGAAACT	ExciteL4
TGTTGGACACTAGGCC	InhibNeuron
TGTTGGAGTTAAGTCC	InhibNeuron
TGTTGGATCGAGAGAC	Astrocytes
TGTTGGATCGCCTAGG	Microglia
TGTTGGATCGGACGTC	Astrocytes
TGTTGGATCTAGACCA	COPs
TGTTTGTAGAAGAACG	ExciteL4
TGTTTGTAGAGAGTGA	COPs
TGTTTGTCAAACGTGG	Microglia
TGTTTGTCACACGTGC	OPCs
TGTTTGTCACTAGAGG	OPCs
TGTTTGTCACTCAAGT	MOLs
TGTTTGTCATAGATCC	OPCs
TGTTTGTGTACTGAGG	MOLs
TGTTTGTGTCCAAGAG	ExciteL4
TGTTTGTGTCCACAGC	ExciteL6
TGTTTGTTCCGTAGGC	MOLs
TGTTTGTTCTGACCCT	Microglia
TTAATCCCAAATCAAG	ExciteL23
TTAATCCCAATTTCGG	MOLs
TTAATCCCATTGCCGG	InhibNeuron
TTAATCCGTGACCTGC	ExciteL4
TTAATCCTCTTGAACG	OPCs
TTACAGGAGCCTTTCC	MOLs
TTACAGGAGGAGGGTG	Endo
TTACAGGAGGCCTTCG	ExciteL4
TTACAGGAGTGTTCAC	MOLs
TTACAGGCACAAGTGG	MOLs
TTACAGGCATGACGTT	InhibNeuron
TTACAGGGTACAGAGC	ExciteL23
TTACAGGGTAGGCTGA	ExciteL4
TTACAGGGTTCGGCGT	ExciteL6
TTACAGGTCAAACCCA	ExciteL4
TTACAGGTCGATTGAC	ExciteNP
TTACCATAGCAACAAT	Astrocytes
TTACCATAGTCTTCCC	Microglia
TTACCATAGTTAACGA	Microglia
TTACCATCACCAGCGT	ExciteL23
TTACCATCATCGCCTT	Astrocytes
TTACCATCATGCACTA	Astrocytes
TTACCATGTCGAGCAA	ExciteL6
TTACCATGTTGGGCCT	OPCs
TTACCATGTTGGGTTT	ExciteL4
TTACCATTCCAAGCAT	Endo
TTACCGCAGAGGGTCT	Microglia
TTACCGCAGCGCTGCT	MOLs
TTACCGCAGTATAGGT	Microglia
TTACCGCAGTTAGTAG	MOLs
TTACCGCCACAGTCAT	OPCs
TTACCGCGTCATCGCG	OPCs
TTACCGCTCGCGAAGA	ExciteL23
TTACGCCAGATCGGTG	ExciteL4
TTACGCCAGTGGTGAC	ExciteL6
TTACGCCAGTTCACTG	OPCs
TTACGCCCAACCCGCA	ExciteL4
TTACGCCCACACCTAA	MOLs
TTACGCCCACCAGCGT	ExciteL4
TTACGCCGTGTGTTTG	ExciteL6
TTACGCCTCGTCTCAC	ExciteL6
TTACGTTCAACCGATT	ExciteL4
TTACGTTCAAGTTGGG	Pericytes
TTACGTTCAGAGCGTA	Fibroblasts
TTACGTTCATAGACTC	COPs
TTACGTTCATTGGCAT	ExciteL4
TTACGTTGTCTACAGT	Macrophages
TTACGTTGTTTACACG	InhibNeuron
TTACGTTTCGACCAAT	ExciteL4
TTACGTTTCTTACCAT	Microglia
TTACTGTAGACGAAGA	MOLs
TTACTGTAGGCTAGCA	Microglia
TTACTGTAGTTCGGTT	MOLs
TTACTGTCAGGATGAC	OPCs
TTACTGTTCGTTCATT	ExciteL23
TTACTGTTCTCAGTCC	ExciteL23
TTAGGCACAATGGGTG	MOLs
TTAGGCACACCATATG	InhibNeuron
TTAGGCACATTAAAGG	Microglia
TTAGGCAGTAGGTACG	MOLs
TTAGGCATCGAGAATA	Microglia
TTAGGCATCGCAGTTA	OPCs
TTAGGGTCAGACAATA	Astrocytes
TTAGGGTGTACCTTCC	Astrocytes
TTAGGGTGTTGTCAGT	InhibNeuron
TTAGGGTTCACGGGAA	ExciteNP
TTAGGGTTCAGCTGAT	ExciteL4
TTAGGGTTCCAATCCC	MOLs
TTAGGGTTCCACTAGA	Microglia
TTAGGGTTCCGGTAGC	Astrocytes
TTAGGGTTCTTTCAGT	ExciteL6
TTAGTCTAGCTGTTAC	MFOLs
TTAGTCTAGGACATCG	Microglia
TTAGTCTAGGGTAATT	ExciteL4
TTAGTCTCAAGGTCTT	Microglia
TTAGTCTCACGGCACT	OPCs
TTAGTCTCAGGAATCG	ExciteL6
TTAGTCTGTACGTAGG	ExciteL6
TTAGTCTTCCATCCGT	Microglia
TTAGTCTTCGCAGAGA	InhibNeuron
TTATTGCAGACCATTC	Astrocytes
TTATTGCCATTGGGAG	ExciteL4
TTATTGCTCAGTCCGG	Microglia
TTCAATCAGGACATCG	COPs
TTCAATCCATGTTCGA	Astrocytes
TTCAATCGTTTCACAG	OPCs
TTCAATCTCTTTCAGT	ExciteL6
TTCACCGAGCGTATAA	Microglia
TTCACCGCAATTGGTC	Astrocytes
TTCACCGTCTAGCATG	ExciteNP
TTCACGCAGCTAGATA	Endo
TTCACGCCAAGAGCTG	ExciteL6
TTCACGCCAGACCGCT	Astrocytes
TTCACGCGTATCGTAC	OPCs
TTCACGCGTGATATAG	COPs
TTCAGGACAACTGGTT	ExciteL4
TTCAGGATCACCATAG	COPs
TTCATGTCATTGAAAG	Pericytes
TTCATGTTCGTGGACC	OPCs
TTCATGTTCTAGGCCG	MOLs
TTCATGTTCTTGTGCC	Astrocytes
TTCATTGAGATACCAA	OPCs
TTCATTGAGCGATGCA	OPCs
TTCATTGAGCGGACAT	ExciteL4
TTCATTGCATAGAATG	Astrocytes
TTCATTGGTATCGTTG	Astrocytes
TTCATTGTCTAGATCG	MOLs
TTCATTGTCTCTCAAT	NIPCs
TTCCAATAGCGTCTGC	ExciteL4
TTCCAATAGGTCGCCT	ExciteL23
TTCCAATCACATGGTT	ExciteL4
TTCCAATTCGCCTAGG	ExciteL23
TTCCACGAGGGTTGCA	Microglia
TTCCACGCACACAGAG	MOLs
TTCCACGCACCTGTCT	ExciteL6
TTCCACGCACGCTGCA	MOLs
TTCCACGGTGAGAACC	Microglia
TTCCACGTCCAGCAAT	Microglia
TTCCACGTCCCTGGTT	OPCs
TTCCACGTCTTACCGC	ExciteL6
TTCCGGTCAACCGTAT	NIPCs
TTCCGGTCAATTAGGA	ExciteL4
TTCCGGTCAGCTGAGA	OPCs
TTCCGGTTCAAGTGTC	ExciteL4
TTCCGGTTCGTTTACT	OPCs
TTCCGTGAGCACACCC	InhibNeuron
TTCCGTGAGGGTACGT	Astrocytes
TTCCGTGCAACACGTT	Microglia
TTCCGTGCACCTTCCA	Microglia
TTCCGTGCACTTGAGT	NIPCs
TTCCGTGCAGCTCATA	ExciteL5
TTCCGTGGTCAAGCGA	ExciteL23
TTCCGTGGTCGCAACC	Microglia
TTCCTAAAGAGAGAAC	Microglia
TTCCTAAAGAGCATTA	COPs
TTCCTAAAGAGTTCGG	MOLs
TTCCTAAAGGGAGTGG	ExciteL4
TTCCTAAAGTCCCAGC	MOLs
TTCCTAAAGTTAGAAC	Microglia
TTCCTAACAAGACGAC	ExciteL4
TTCCTAACAAGCCTGC	ExciteL6
TTCCTAACAAGTCGTT	Microglia
TTCCTAACACATGTTG	ExciteL23
TTCCTAACATTCAGCA	ExciteL4
TTCCTAAGTAGCGTTT	ExciteL4
TTCCTAAGTTGCATAC	COPs
TTCCTAATCCCTCGTA	ExciteL6
TTCCTCTAGCCACAAG	ExciteL23
TTCCTCTAGGCGATAC	Astrocytes
TTCCTCTAGGTCTACT	NIPCs
TTCCTCTCATGAGTAA	OPCs
TTCCTCTGTGAGATTA	OPCs
TTCCTCTTCACTACGA	Endo
TTCCTTCAGATCCAAA	MOLs
TTCCTTCAGGAAAGAC	MOLs
TTCCTTCAGGACAGTC	Microglia
TTCCTTCCAGAACGCA	OPCs
TTCCTTCCAGACCTAT	MOLs
TTCCTTCCAGGCGTTC	Microglia
TTCCTTCGTAGCTTGT	ExciteL4
TTCCTTCGTATCGCAT	Astrocytes
TTCCTTCGTTAAGACA	ExciteL6
TTCCTTCTCAAGGCTT	ExciteL6
TTCCTTCTCTTCTGTA	Microglia
TTCGATTAGAAGCCAC	InhibNeuron
TTCGATTTCCCTCTTT	Pericytes
TTCGATTTCGAGTCTA	Astrocytes
TTCGATTTCGCCTATC	ExciteL4
TTCGATTTCTTGGCTC	Astrocytes
TTCGCTGCAAGAGAGA	COPs
TTCGCTGGTCTTCCGT	MOLs
TTCGCTGGTGAGAACC	MOLs
TTCGCTGGTGAGCGAT	Microglia
TTCGGTCAGGGAGGTG	Microglia
TTCGGTCAGTTCCGTA	OPCs
TTCGGTCCACAAATCC	COPs
TTCGGTCCAGCTGAAG	ExciteL6
TTCGGTCCATAGGTTC	ExciteL6
TTCGGTCGTAACCCGC	OPCs
TTCGGTCGTGAGATAT	Microglia
TTCGGTCGTTACGATC	ExciteL6
TTCGGTCTCAAGTGGG	Microglia
TTCGGTCTCGAGAGAC	OPCs
TTCTAACAGGCATCAG	MOLs
TTCTAACAGGGCGAGA	Microglia
TTCTAACGTAACATCC	COPs
TTCTAACGTCTAGGCC	ExciteL4
TTCTAACGTGCCTAAT	Astrocytes
TTCTAACTCCTCTAGC	Microglia
TTCTAACTCTGGTGGC	ExciteL4
TTCTAGTAGCCTTGAT	ExciteL23
TTCTAGTAGTATCTGC	Microglia
TTCTAGTCACCCAACG	Microglia
TTCTAGTCAGTCGCTG	OPCs
TTCTAGTTCCTGCCAT	OPCs
TTCTAGTTCGGCACTG	ExciteL23
TTCTCTCAGAGCCTGA	OPCs
TTCTCTCAGGATTTAG	Microglia
TTCTCTCAGGCGATAC	ExciteL6
TTCTCTCCAAGGTTGG	OPCs
TTCTCTCCACAGGATG	Microglia
TTCTCTCCACCAGCGT	OPCs
TTCTCTCCACTCTCGT	MOLs
TTCTCTCGTAATGCTC	ExciteL4
TTCTCTCGTACTAGCT	ExciteNP
TTCTCTCGTTAAGCAA	ExciteL4
TTCTCTCTCGCTATTT	ExciteL6
TTCTGTAAGTAGGGTC	OPCs
TTCTGTACATAGGTAA	MOLs
TTCTGTAGTCAAAGAT	MOLs
TTCTGTAGTCACTGAT	OPCs
TTCTGTAGTCTTTCAT	Microglia
TTCTGTAGTGGGAGAG	OPCs
TTCTTCCCAATCTCGA	ExciteL4
TTCTTCCCACATACTG	ExciteL6
TTCTTCCCAGCACCCA	ExciteL4
TTCTTCCCAGCAGTTT	ExciteL4
TTCTTCCCATCAGTCA	MOLs
TTCTTCCGTATCTTCT	Microglia
TTCTTCCGTATTGCCA	ExciteL23
TTCTTCCGTCGGATTT	ExciteL5
TTCTTCCGTGGCTAGA	Astrocytes
TTCTTCCTCGGCTGAC	MOLs
TTCTTGAAGCACCGAA	Pericytes
TTCTTGAAGGGACTGT	OPCs
TTCTTGACACTCCGGA	ExciteL4
TTCTTGACATACAGAA	MOLs
TTCTTGAGTACGACAG	Microglia
TTCTTGAGTAGTACGG	NIPCs
TTCTTGATCCGCTTAC	Astrocytes
TTCTTGATCTTCGGTC	Microglia
TTGAACGAGACAAGCC	Astrocytes
TTGAACGAGACTCTAC	ExciteL4
TTGAACGAGCCTGAGA	ExciteL4
TTGAACGCAAGGATGC	ExciteL4
TTGAACGGTTAAACCC	ExciteL23
TTGAACGGTTCGATTG	Microglia
TTGAACGGTTGCGAAG	MOLs
TTGAACGTCCCGTAAA	Microglia
TTGAACGTCGATCCAA	COPs
TTGACCCAGAATAGTC	OPCs
TTGACCCAGAGAGTTT	ExciteL4
TTGACCCAGATAACGT	ExciteL4
TTGACCCAGCGTTCAT	ExciteL4
TTGACCCAGTACGTCT	ExciteL6
TTGACCCAGTGAATAC	ExciteL4
TTGACCCAGTGGCGAT	Microglia
TTGACCCCACTAACCA	OPCs
TTGACCCCATCCTATT	MOLs
TTGACCCCATGCCGCA	OPCs
TTGACCCGTCGAACAG	ExciteL6
TTGACCCTCATCGCTC	ExciteL5
TTGACCCTCCACTGGG	ExciteL4
TTGACCCTCGTTAGTG	ExciteL6
TTGAGTGAGGATTTCC	MOLs
TTGAGTGAGGTAAAGG	ExciteL4
TTGAGTGCAAGAGTTA	ExciteL6
TTGAGTGCAATAGAGT	MOLs
TTGAGTGGTAACATAG	Microglia
TTGAGTGGTACGTACT	MOLs
TTGAGTGGTTGCCTAA	ExciteL4
TTGAGTGTCGTCAGAT	ExciteL4
TTGATGGCAACTGCTA	InhibNeuron
TTGATGGCACCTCAGG	Microglia
TTGATGGGTATGAAGT	InhibNeuron
TTGATGGGTCTCGCGA	OPCs
TTGATGGGTGGCCCAT	ExciteL23
TTGATGGGTGTCTTGA	MOLs
TTGCATTAGACTCTAC	Astrocytes
TTGCATTCAATAGAGT	InhibNeuron
TTGCATTCAATGCAAA	Microglia
TTGCATTCAGTAGAAT	Microglia
TTGCATTCAGTCAACT	Microglia
TTGCATTGTCACAGAG	Astrocytes
TTGCATTGTCTAGTGT	Endo
TTGCATTGTGTCATCA	MOLs
TTGCATTGTGTTCCAA	ExciteL6
TTGCATTGTTGCTCAA	ExciteL4
TTGCATTTCGCATAGT	Microglia
TTGCATTTCTCGACGG	InhibNeuron
TTGCCTGGTGAATATG	COPs
TTGCCTGGTTAATGAG	MOLs
TTGCCTGGTTCCACGG	ExciteL4
TTGCCTGTCTCCTGTG	ExciteL6
TTGCGTCAGTCACTGT	ExciteL4
TTGCGTCCAGGAGGTT	Astrocytes
TTGCGTCGTCCTGGGT	ExciteL4
TTGCGTCTCGGATTAC	ExciteL4
TTGCTGCGTGGACCAA	ExciteL6
TTGCTGCTCCAACTGA	ExciteNP
TTGCTGCTCCCGAACG	ExciteL5
TTGCTGCTCCTTCACG	Microglia
TTGCTGCTCGTAACCA	ExciteL6
TTGCTGCTCTGCACCT	ExciteL4
TTGGATGAGACGTCCC	ExciteL4
TTGGATGAGCACTCTA	Microglia
TTGGATGAGCGATGCA	COPs
TTGGATGAGTTGGAAT	Microglia
TTGGATGCAAGAGCTG	Astrocytes
TTGGATGCAGACAATA	ExciteL4
TTGGATGGTTGGGACA	Microglia
TTGGATGTCAACCCGG	ExciteL6
TTGGATGTCATGAGAA	Microglia
TTGGATGTCCAACACA	OPCs
TTGGATGTCCGTTGAA	MOLs
TTGGATGTCGGTATGT	COPs
TTGGATGTCTTAGCAG	OPCs
TTGGGATAGTCGAATA	MOLs
TTGGGATAGTGCAGGT	ExciteL4
TTGGGATAGTTTAGGA	ExciteL4
TTGGGATCAATCGCGC	Microglia
TTGGGATCAGCGTTTA	ExciteL4
TTGGGATTCCTCACGT	Microglia
TTGGGATTCTAGGCAT	ExciteL5
TTGGGCGAGCAACTCT	Microglia
TTGGGCGGTATGGAAT	Microglia
TTGGGCGGTTGCTCAA	Pericytes
TTGGGTAAGGGTGGGA	Microglia
TTGGGTACACATGGTT	COPs
TTGGGTAGTGCAGTGA	MOLs
TTGGGTAGTGCGTTTA	Endo
TTGGGTATCGAAGTGG	ExciteL4
TTGGTTTAGAGCACTG	Astrocytes
TTGGTTTCACCTATCC	ExciteL6
TTGGTTTCATAGAAAC	Microglia
TTGGTTTGTCGCGTTG	Microglia
TTGGTTTGTTACCCAA	ExciteL4
TTGGTTTTCTAACGGT	ExciteL6
TTGTGGAAGCTACTAC	ExciteL4
TTGTGGACATTCTCCG	Endo
TTGTGGAGTCCAGTTA	ExciteL23
TTGTGGAGTGGCCTCA	OPCs
TTGTGGAGTGTGACCC	OPCs
TTGTGGATCGATAACC	ExciteL4
TTGTGGATCGATTCCC	ExciteL4
TTGTGGATCGGATACT	MOLs
TTGTGTTAGTAATTGG	MOLs
TTGTGTTCAAGGGCAT	MOLs
TTGTGTTCAGTGTACT	MOLs
TTGTGTTCATGATAGA	ExciteL6
TTGTGTTGTCACTTAG	OPCs
TTGTGTTGTCTGCCTT	Astrocytes
TTGTTCAAGGCTCAAG	Microglia
TTGTTCAAGTAAACTG	Pericytes
TTGTTCAAGTTGGACG	ExciteL5
TTGTTCACAACTGCTA	InhibNeuron
TTGTTCACACAATGTC	ExciteL4
TTGTTCACATGCCGAC	Macrophages
TTGTTCAGTATAATGG	ExciteL4
TTGTTCAGTGGGCTTC	Microglia
TTGTTCAGTTTCGTTT	Astrocytes
TTGTTCATCTTACCGC	MOLs
TTGTTGTCACCATAAC	ExciteL4
TTGTTGTCACTTCCTG	Astrocytes
TTGTTGTGTCTCTCAC	Astrocytes
TTGTTGTGTTCAGCGC	OPCs
TTGTTGTTCGAGCACC	Astrocytes
TTGTTGTTCGCTCTAC	OPCs
TTGTTTGAGAAGCGAA	ExciteL23
TTGTTTGAGCAAGGAA	Microglia
TTGTTTGAGGCTAGCA	ExciteL6
TTGTTTGAGTCGAATA	Ependymal
TTGTTTGCACGTACTA	ExciteL6
TTTACCAAGTTTGGCT	Microglia
TTTACCACACATTCTT	Microglia
TTTACCAGTCCTTAAG	OPCs
TTTACCAGTGCACATT	Microglia
TTTACCAGTGGCCCAT	Microglia
TTTACCATCGTAACTG	Astrocytes
TTTACGTAGACTCGAG	InhibNeuron
TTTACGTAGTCACGCC	ExciteL5
TTTACGTCACTACAGT	ExciteL4
TTTACGTCAGCACAAG	COPs
TTTACGTCATCAACCA	OPCs
TTTACGTGTCTCTCAC	InhibNeuron
TTTACGTGTCTTCAAG	Microglia
TTTACGTTCCTGTTAT	InhibNeuron
TTTACTGAGCCTGGAA	ExciteL23
TTTACTGAGGCCTAAG	Endo
TTTACTGCACTACCCT	Microglia
TTTACTGGTCAGTCTA	ExciteL4
TTTACTGGTGCAATAA	MOLs
TTTACTGTCGTTGCCT	MOLs
TTTAGTCAGCCGATAG	Microglia
TTTAGTCAGTCCTGTA	MOLs
TTTAGTCCAAGACGAC	MOLs
TTTAGTCCACGAAAGC	Microglia
TTTAGTCGTACTGTTG	NIPCs
TTTAGTCGTTGGTACT	OPCs
TTTAGTCTCAAGCGTT	MOLs
TTTATGCAGTCATGAA	Microglia
TTTATGCAGTGAACAT	MOLs
TTTATGCAGTGCCCGT	COPs
TTTATGCCAACCGCTG	ExciteL4
TTTATGCCACTGAGTT	ExciteL6
TTTATGCCAGCAGATG	InhibNeuron
TTTATGCCATCACAGT	OPCs
TTTATGCGTGTCCACG	MOLs
TTTATGCTCACCACAA	ExciteL4
TTTATGCTCACCCTCA	NIPCs
TTTATGCTCATTTCGT	Microglia
TTTATGCTCCAACACA	COPs
TTTATGCTCCTCATAT	OPCs
TTTCACAAGCGGTATG	MOLs
TTTCACAAGTATTAGG	MOLs
TTTCACAAGTCACAGG	Astrocytes
TTTCACACAACCGCCA	Microglia
TTTCACACAGATCACT	Microglia
TTTCACAGTATGTCAC	OPCs
TTTCACAGTCGCCTAG	OPCs
TTTCACAGTGTTCATG	Astrocytes
TTTCACATCACGATCA	ExciteL4
TTTCACATCATAGGCT	Microglia
TTTCAGTAGAGTGTGC	OPCs
TTTCAGTAGCATCCCG	Microglia
TTTCAGTCAACCGTAT	ExciteNP
TTTCAGTCACGTAGAG	ExciteL6
TTTCAGTCAGAGCGTA	MOLs
TTTCAGTCATACTTTC	Astrocytes
TTTCAGTGTACCCGCA	ExciteL4
TTTCAGTGTCAATCTG	Astrocytes
TTTCAGTTCCTTGGAA	ExciteL4
TTTCATGAGAGATTCA	MOLs
TTTCATGAGCGAACTG	ExciteL4
TTTCATGAGGGTACAC	MOLs
TTTCATGAGGTTACAA	ExciteL4
TTTCATGAGTGAGGTC	Microglia
TTTCATGAGTGTCATC	MOLs
TTTCATGCACGCCACA	InhibNeuron
TTTCATGCACTGTCCT	ExciteL4
TTTCATGCAGAATCGG	MOLs
TTTCATGCAGACTGCC	Astrocytes
TTTCATGCAGTAGTTC	ExciteNP
TTTCATGGTAGATGTA	ExciteL23
TTTCATGGTCGCAACC	ExciteNP
TTTCATGGTGAGCCAA	MOLs
TTTCATGGTTGAGAGC	ExciteL4
TTTCATGTCAGTAGGG	MOLs
TTTCATGTCGCGTGCA	ExciteL4
TTTCCTCAGACGCCCT	ExciteL4
TTTCCTCCAGGTATGG	ExciteL4
TTTCCTCGTAACAAGT	Microglia
TTTCGATAGCCTGACC	OPCs
TTTCGATAGGAGATAG	MOLs
TTTCGATCAATAGAGT	OPCs
TTTCGATCATGCAGGA	ExciteL23
TTTCGATCATTGACAC	ExciteL5
TTTCGATGTGGCGTAA	MOLs
TTTCGATTCTCTAGGA	InhibNeuron
TTTGACTAGGGAGGGT	OPCs
TTTGACTCAATGGCAG	ExciteL6
TTTGACTCAATTGCTG	MOLs
TTTGACTCATGCCGGT	OPCs
TTTGACTCATTGCTTT	Microglia
TTTGACTGTAACTAAG	Macrophages
TTTGACTGTCTTGAAC	COPs
TTTGACTTCGCGTGCA	MOLs
TTTGACTTCTACCCAC	Microglia
TTTGATCAGTGCTCGC	ExciteL23
TTTGATCCAATTGCGT	OPCs
TTTGATCGTCATAAAG	Microglia
TTTGATCTCACCCATC	Microglia
TTTGGAGAGAGCTGCA	InhibNeuron
TTTGGAGAGATTCGCT	COPs
TTTGGAGAGCATCCTA	NIPCs
TTTGGAGAGCCATTGT	Astrocytes
TTTGGAGCACAAGGTG	Microglia
TTTGGAGCAGGTGGAT	Microglia
TTTGGAGGTATCGTTG	MOLs
TTTGGAGGTTGTGTTG	Microglia
TTTGGAGTCAACACCA	ExciteL4
TTTGGAGTCCGTTGAA	ExciteNP
TTTGGAGTCTCAGAAC	Astrocytes
TTTGGAGTCTCGTCGT	Microglia
TTTGGAGTCTGACAGT	NIPCs
TTTGGTTAGACCCTTA	MOLs
TTTGGTTAGACTGGGT	ExciteL6
TTTGGTTAGCGCCTAC	ExciteL6
TTTGGTTAGTGGATAT	Microglia
TTTGGTTCAAGGCGTA	ExciteL4
TTTGGTTCACTTGTCC	OPCs
TTTGGTTTCACGATCA	NIPCs
TTTGGTTTCCCATAGA	ExciteL6
TTTGTTGAGTGGAATT	Astrocytes
TTTGTTGCACAATGAA	ExciteL4
TTTGTTGGTGAAGCTG	Microglia
TTTGTTGTCAACGTGT	ExciteL4
TTTGTTGTCACGGACC	InhibNeuron
TTTGTTGTCCCTCTTT	COPs
